item_name	category_name	cate_1_name	cate_2_name	cate_3_name
一个小米粥两个吊炉饼一个小菜	其他菜品	其他	其他菜品	
一人份小番茄汤	汤羹	菜品	汤羹	
一人份番茄鸡蛋汤	汤羹	菜品	汤羹	
一份大头菜	蔬菜类	火锅/串串/麻辣烫/色拉自选	配菜	蔬菜类
一份饺子一份粥	其他菜品	其他	其他菜品	
一品中宁清炖土鸡一只	热菜	菜品	热菜	
一品南瓜粥	粥	主食	粥	
一品大炖菜	热菜	菜品	热菜	
一品娃娃菜	热菜	菜品	热菜	
一品海鲜粥	粥	主食	粥	
一品清炖土鸡	热菜	菜品	热菜	
一品清炖土鸡单人套餐	其他菜品	其他	其他菜品	
一品疙瘩汤	汤羹	菜品	汤羹	
一品艇仔粥	粥	主食	粥	
一品蔬菜粥	粥	主食	粥	
一品鲜炒土豆丝	热菜	菜品	热菜	
一品鲜虾砂锅粥	粥	主食	粥	
一品鲜虾粥	粥	主食	粥	
一大荤一小荤两素菜一饭	其他菜品	其他	其他菜品	
一家亲手擀面	手擀面	主食	面	手擀面
一整颗雪梨汤	其他甜品	甜点	其他甜品	
一杯小米粥	粥	主食	粥	
一桶番茄鸡蛋汤	汤羹	菜品	汤羹	
一盘烤花菜	蔬菜类	烧烤	蔬菜类	
一碗地瓜粥	粥	主食	粥	
一碗好米饭	白米饭	主食	饭	白米饭
一碗安静的白米饭	白米饭	主食	饭	白米饭
一碗常被爸妈叮嘱的白米饭	白米饭	主食	饭	白米饭
一碗白米饭	白米饭	主食	饭	白米饭
一碗神仙皮蛋瘦肉粥	粥	主食	粥	
一碗蔬菜粥	粥	主食	粥	
一碗西红柿鸡蛋汤	汤羹	菜品	汤羹	
一碗香喷喷的白米饭	白米饭	主食	饭	白米饭
一级小米粥	粥	主食	粥	
一肉三素拼单菜不含米饭	其他饭	主食	饭	其他饭
一肉三素盒饭	其他饭	主食	饭	其他饭
一荤三素一饭	其他菜品	其他	其他菜品	
一荤三素含米饭	其他菜品	其他	其他菜品	
一荤两素加米饭	其他菜品	其他	其他菜品	
七彩什锦汤	汤羹	菜品	汤羹	
七彩干贝汤	汤羹	菜品	汤羹	
七彩芋圆杂粮粥	粥	主食	粥	
七色营养粥	粥	主食	粥	
三丁茄子饭	盖浇饭	主食	饭	盖浇饭
三丝打卤面	盖浇面	主食	面	盖浇面
三丝敲鱼汤	汤羹	菜品	汤羹	
三丝敲鱼米面	米线	主食	粉	米线
三丝素鸡冷面	凉面	主食	面	凉面
三丝酸辣汤	汤羹	菜品	汤羹	
三丝阳春面	汤面	主食	面	汤面
三个素菜盒饭	其他饭	主食	饭	其他饭
三千里荞麦冷面	凉面	主食	面	凉面
三口一品农家泡菜	凉菜	菜品	凉菜	
三婶子疙瘩汤	汤羹	菜品	汤羹	
三宝乌鸡粥	粥	主食	粥	
三宝海鲜粥	粥	主食	粥	
三小时八宝粥	粥	主食	粥	
三峡农家炖豆腐	热菜	菜品	热菜	
三文鱼低脂番茄意面	意大利面	主食	面	意大利面
三文鱼味噌汤	汤羹	菜品	汤羹	
三文鱼牛油果海鲜饭	盖浇饭	主食	饭	盖浇饭
三文鱼茶泡饭	泡饭	主食	饭	泡饭
三更美龄粥	粥	主食	粥	
三碗豆腐小碗肉酱两碗高粱米饭	其他菜品	其他	其他菜品	
三种菌菇炒肉	其他菜品	其他	其他菜品	
三米红豆黑米粥	粥	主食	粥	
三米绿色青菜粥	粥	主食	粥	
三米豆角焖面	焖面	主食	面	焖面
三米青菜粥	粥	主食	粥	
三素三肉盒饭	其他饭	主食	饭	其他饭
三色糙米饭	热菜	菜品	热菜	
三荤一炒二素套餐	其他菜品	其他	其他菜品	
三荤两素一饭	其他饭	主食	饭	其他饭
三荤两素加米饭	其他菜品	其他	其他菜品	
三荤二素一汤一饭	其他菜品	其他	其他菜品	
三荤二素一饭一汤	其他菜品	其他	其他菜品	
三药炒木耳	热菜	菜品	热菜	
三菇炒肉丝	热菜	菜品	热菜	
三鲜一品豆腐饭	盖浇饭	主食	饭	盖浇饭
三鲜丝瓜面	汤面	主食	面	汤面
三鲜乌冬面	乌冬面	主食	面	乌冬面
三鲜刀削面	其他面	主食	面	其他面
三鲜大烩菜	热菜	菜品	热菜	
三鲜姜汁米面	米线	主食	粉	米线
三鲜姜汤面	汤面	主食	面	汤面
三鲜娃娃菜	热菜	菜品	热菜	
三鲜山粉面	汤面	主食	面	汤面
三鲜打卤面	盖浇面	主食	面	盖浇面
三鲜杂烩汤	热菜	菜品	热菜	
三鲜汤带丝汤	汤羹	菜品	汤羹	
三鲜汤泡饭	泡饭	主食	饭	泡饭
三鲜炒芦笋	热菜	菜品	热菜	
三鲜珍珠汤	汤羹	菜品	汤羹	
三鲜疙瘩汤	汤羹	菜品	汤羹	
三鲜白丸汤	汤羹	菜品	汤羹	
三鲜砂锅粥	粥	主食	粥	
三鲜粉丝汤	其他粉	主食	粉	其他粉
三鲜素烩饭	烩饭	主食	饭	烩饭
三鲜紫菜蛋花汤	汤羹	菜品	汤羹	
三鲜绿豆面	汤面	主食	面	汤面
三鲜茄子双拼饭	盖浇饭	主食	饭	盖浇饭
三鲜菜泡饭	泡饭	主食	饭	泡饭
三鲜豆腐汤	汤羹	菜品	汤羹	
三鲜醋椒豆腐汤	汤羹	菜品	汤羹	
三鲜青菜泡饭	泡饭	主食	饭	泡饭
三鲜鱼丸汤	汤羹	菜品	汤羹	
三鲜鸡蛋汤	汤羹	菜品	汤羹	
三鲜黄鱼面	汤面	主食	面	汤面
三黑乌发粥	粥	主食	粥	
上品娃娃菜	蔬菜类	烧烤	配菜	蔬菜类
上汤娃娃菜	热菜	菜品	热菜	
上汤广东西洋菜	热菜	菜品	热菜	
上汤时令蔬菜	热菜	菜品	热菜	
上汤白苋菜	热菜	菜品	热菜	
上汤红苋菜	热菜	菜品	热菜	
上汤西洋菜	热菜	菜品	热菜	
上汤金花菜	热菜	菜品	热菜	
上汤鸡毛菜	热菜	菜品	热菜	
上海卤蛋蔬菜面	汤面	主食	面	汤面
上海小青菜	蔬菜类	火锅/串串/麻辣烫/色拉自选	配菜	蔬菜类
上海粉丝汤	其他粉	主食	粉	其他粉
上海菜泡饭	泡饭	主食	饭	泡饭
上海青油菜	蔬菜类	火锅/串串/麻辣烫/色拉自选	配菜	蔬菜类
上海青炒豆筋	热菜	菜品	热菜	
下单免费送自制小菜	凉菜	菜品	凉菜	
下达河豆干炒蒜苗	热菜	菜品	热菜	
下锅烂扇贝蛋花疙瘩汤	汤羹	菜品	汤羹	
下锅烂海蛎子豆腐汤	汤羹	菜品	汤羹	
下锅烂疙瘩汤	汤羹	菜品	汤羹	
下锅烂蛋花汤	汤羹	菜品	汤羹	
下锅烂蛋花疙瘩汤	汤羹	菜品	汤羹	
下锅烂鱼丸汤	汤羹	菜品	汤羹	
下饭八宝菜	凉菜	菜品	凉菜	
下饭的西红柿炒鸡蛋	热菜	菜品	热菜	
下饭菜炒鸡蛋	热菜	菜品	热菜	
下饭黄瓜小咸菜	凉菜	菜品	凉菜	
不一样的包菜	热菜	菜品	热菜	
不想长大的娃娃菜	蔬菜类	火锅/串串/麻辣烫/色拉自选	配菜	蔬菜类
不放葱的蛋炒饭	炒饭	主食	饭	炒饭
不油腻的油麦菜	蔬菜类	火锅/串串/麻辣烫/色拉自选	配菜	蔬菜类
不辣热汤荞麦面	汤面	主食	面	汤面
不辣选我丨葱油刀削面	其他面	主食	面	其他面
不需要米饭	白米饭	小吃	饭	白米饭
不麻不辣可加两种面	蔬菜类	火锅/串串/麻辣烫/色拉自选	配菜	蔬菜类
丙洲一品粥	粥	主食	粥	
东关小瘦肉丸子汤	汤羹	菜品	汤羹	
东北五常大米饭	白米饭	主食	饭	白米饭
东北五常米饭	白米饭	主食	饭	白米饭
东北五常香米饭	白米饭	主食	饭	白米饭
东北养生拌菜	凉菜	菜品	凉菜	
东北冻豆腐炖白菜	热菜	菜品	热菜	
东北大拌菜	凉菜	菜品	凉菜	
东北大白菜炖豆腐	热菜	菜品	热菜	
东北大盘凉菜	凉菜	菜品	凉菜	
东北大碴子粥	粥	主食	粥	
东北大碴粥	粥	主食	粥	
东北大米米饭	白米饭	主食	饭	白米饭
东北大米饭	白米饭	其他	饭	白米饭
东北大米饭饭饭饭饭饭	白米饭	主食	饭	白米饭
东北大酱炒鸡蛋	热菜	菜品	热菜	
东北大馇粥	粥	主食	粥	
东北家常凉菜	凉菜	菜品	凉菜	
东北家常大炖菜	热菜	菜品	热菜	
东北家常炖菜	热菜	菜品	热菜	
东北小碴粥	粥	主食	粥	
东北小米粥	粥	主食	粥	
东北小鸡炖蘑菇	热菜	菜品	热菜	
东北小鸡炖蘑菇小份	热菜	菜品	热菜	
东北小鸡炖蘑菇粉	热菜	菜品	热菜	
东北慢炖酸菜	热菜	菜品	热菜	
东北打卤面	盖浇面	主食	面	盖浇面
东北无常香米饭	白米饭	主食	饭	白米饭
东北有机米饭	白米饭	主食	饭	白米饭
东北木耳炒蘑菇	热菜	菜品	热菜	
东北木耳炒鸡蛋	热菜	菜品	热菜	
东北炒合菜	热菜	菜品	热菜	
东北炖豆角盖饭	盖浇饭	主食	饭	盖浇饭
东北特色疙瘩汤	汤羹	菜品	汤羹	
东北玉米面	其他菜品	其他	其他菜品	
东北珍珠大米饭	白米饭	主食	饭	白米饭
东北珍珠米饭	白米饭	主食	饭	白米饭
东北珍珠香白米饭	白米饭	主食	饭	白米饭
东北疙瘩汤	汤羹	菜品	汤羹	
东北白米饭	白米饭	主食	饭	白米饭
东北盘锦大米饭	白米饭	主食	饭	白米饭
东北碴子粥	粥	主食	粥	
东北稻花香米饭	白米饭	主食	饭	白米饭
东北稻香白米饭	白米饭	主食	饭	白米饭
东北老家疙瘩汤	汤羹	菜品	汤羹	
东北自酿黄豆酱炒蛋	热菜	菜品	热菜	
东北芹菜炒粉条	热菜	菜品	热菜	
东北茄子炖土豆	热菜	菜品	热菜	
东北蒜苗炒蛋	热菜	菜品	热菜	
东北蘸酱菜	凉菜	菜品	凉菜	
东北蟹田大米米饭	白米饭	主食	饭	白米饭
东北酱炒蛋	热菜	菜品	热菜	
东北酸菜炒粉	热菜	菜品	热菜	
东北酸菜炒粉丝	热菜	菜品	热菜	
东北酸菜炒粉小份	热菜	菜品	热菜	
东北酸菜炒粉条	热菜	菜品	热菜	
东北铁盆拌菜	凉菜	菜品	凉菜	
东北长粒香大米饭	白米饭	主食	饭	白米饭
东北长粒香米饭	白米饭	主食	饭	白米饭
东北香米饭	白米饭	主食	饭	白米饭
东北高粱米水饭	白米饭	主食	饭	白米饭
东北黄瓜拉皮无米饭	凉菜	菜品	凉菜	
东北黄粗面	其他菜品	其他	其他菜品	
东北黑木耳炒白菜	热菜	菜品	热菜	
东北黑木耳炒肉	热菜	菜品	热菜	
东北黑木耳青椒炒肉	热菜	菜品	热菜	
东北黑白菜	热菜	菜品	热菜	
东坞山腐皮炒青菜	热菜	菜品	热菜	
东山紫菜饭	焖饭	主食	饭	焖饭
东方大拌菜	凉菜	菜品	凉菜	
东阳炒粉丝	热菜	菜品	热菜	
丝瓜三鲜面	汤面	主食	面	汤面
丝瓜土鸡蛋汤	汤羹	菜品	汤羹	
丝瓜大虾汤	汤羹	菜品	汤羹	
丝瓜家常炒	热菜	菜品	热菜	
丝瓜扇贝柱鸡蛋汤	汤羹	菜品	汤羹	
丝瓜撒子汤	汤羹	菜品	汤羹	
丝瓜榨菜蛋汤	汤羹	菜品	汤羹	
丝瓜毛豆炒肉片	热菜	菜品	热菜	
丝瓜滑蛋面	汤面	主食	面	汤面
丝瓜炒土鸡蛋	热菜	菜品	热菜	
丝瓜炒毛豆	热菜	菜品	热菜	
丝瓜炒毛豆子	热菜	菜品	热菜	
丝瓜炒毛豆米	热菜	菜品	热菜	
丝瓜炒番茄	热菜	菜品	热菜	
丝瓜炒笋干	热菜	菜品	热菜	
丝瓜炒肉丝	热菜	菜品	热菜	
丝瓜炒花蛤	热菜	菜品	热菜	
丝瓜炒虾皮	热菜	菜品	热菜	
丝瓜炒蛤蜊	热菜	菜品	热菜	
丝瓜炒西红柿	热菜	菜品	热菜	
丝瓜炒豆瓣	热菜	菜品	热菜	
丝瓜炒豆米	热菜	菜品	热菜	
丝瓜炒面筋	热菜	菜品	热菜	
丝瓜炒韭菜	热菜	菜品	热菜	
丝瓜炒鸡蛋	热菜	菜品	热菜	
丝瓜炒鸡蛋盖饭	盖浇饭	主食	饭	盖浇饭
丝瓜炒鹿茸菇	热菜	菜品	热菜	
丝瓜炖面筋	热菜	菜品	热菜	
丝瓜番茄蛋汤	汤羹	菜品	汤羹	
丝瓜笋干面	盖浇面	主食	面	盖浇面
丝瓜肉片汤	汤羹	菜品	汤羹	
丝瓜蛋花汤	汤羹	菜品	汤羹	
丝瓜螺仔汤	汤羹	菜品	汤羹	
丝瓜锦粉面	汤面	主食	面	汤面
丝瓜鱼元汤	汤羹	菜品	汤羹	
丝瓜鸡蛋扁面	汤面	主食	面	汤面
丝瓜鸡蛋拌面	拌面	主食	面	拌面
丝瓜鸡蛋汤	汤羹	菜品	汤羹	
丝瓜鸡蛋盖浇饭	盖浇饭	主食	饭	盖浇饭
丝瓜鸡蛋粉丝汤	其他粉	主食	粉	其他粉
丝瓜鸡蛋面	汤面	主食	面	汤面
丝苗白米饭	白米饭	主食	饭	白米饭
丝苗香米饭	白米饭	主食	饭	白米饭
两个标准火烧一个疙瘩汤	汤羹	菜品	汤羹	
两个鸡蛋砂汤	汤羹	菜品	汤羹	
两块排骨白菜含米饭	其他菜品	其他	其他菜品	
两荤一素套餐米饭	其他菜品	其他	其他菜品	
两荤两素带米饭	其他菜品	其他	其他菜品	
严选山楂粥	粥	主食	粥	
中份冬瓜肋边米饭	热菜	菜品	热菜	
中份小炒菜花	热菜	菜品	热菜	
中份小炒豆芽	热菜	菜品	热菜	
中份小白菜炒蛋	热菜	菜品	热菜	
中份海带肋边米饭	其他菜品	其他	其他菜品	
中份火爆大头菜	热菜	菜品	热菜	
中份炒三丝	热菜	菜品	热菜	
中份炒土豆丝	热菜	菜品	热菜	
中份白菜肋边米饭	其他菜品	其他	其他菜品	
中份粢米饭	其他饭	主食	饭	其他饭
中份肋边白菜	其他菜品	其他	其他菜品	
中份西红柿肋边米饭	热菜	菜品	热菜	
中份野菌汤	汤羹	菜品	汤羹	
中份韭菜沫炒鸡蛋	热菜	菜品	热菜	
中份韭菜炒鸡蛋	热菜	菜品	热菜	
中华八宝粥	粥	主食	粥	
中华海草小菜	凉菜	菜品	凉菜	
中华裙带菜	凉菜	菜品	凉菜	
中卫杂拌菜	凉菜	菜品	凉菜	
中宁清炖土鸡	热菜	菜品	热菜	
中街老鸭粉丝汤	其他粉	主食	粉	其他粉
中骨海带汤	汤羹	菜品	汤羹	
丰收压锅菜	热菜	菜品	热菜	
丰收蘸酱菜	凉菜	菜品	凉菜	
串串豆皮卷贡菜	蔬菜类	火锅/串串/麻辣烫/色拉自选	配菜	蔬菜类
丸子木耳烧白菜	热菜	菜品	热菜	
丸子烧木耳白菜	热菜	菜品	热菜	
丸子粉丝小白菜	其他粉	主食	粉	其他粉
丸子萝卜汤	汤羹	菜品	汤羹	
丸子萝卜粉丝汤	其他粉	主食	粉	其他粉
主题海陆双拼荞麦面	健康餐	色拉轻食	健康餐	
丽华园洪湖藕汤	汤羹	菜品	汤羹	
之补山药排骨粥	粥	主食	粥	
乌米八宝粥	粥	主食	粥	
乌米绿豆汤	糖水/炖品	甜点	糖水/炖品	
乌豆熟地降火汤	汤羹	菜品	汤羹	
乌鱼蛋疙瘩汤	汤羹	菜品	汤羹	
乌鸡三鲜面	汤面	主食	面	汤面
乌鸡养心粥	粥	主食	粥	
乌鸡汤三鲜面	汤面	主食	面	汤面
乌鸡汤套餐饭	其他菜品	其他	其他菜品	
乌鸡汤套饭	其他菜品	其他	其他菜品	
乌鸡汤炖罐	汤羹	菜品	汤羹	
乌鸡汤馄炖	馄饨	主食	馄饨	
乌鸡炖汤小馄饨	馄饨	主食	馄饨	
乌鸡炖罐汤	汤羹	菜品	汤羹	
乌鸡瓦罐汤	汤羹	菜品	汤羹	
乌鸡砂锅粥	粥	主食	粥	
乌鸡红枣瓦罐汤	汤羹	菜品	汤羹	
乌鸡罐罐面	汤面	主食	面	汤面
乌鸡肉丁煲汤	汤羹	菜品	汤羹	
乌鸡药膳汤	汤羹	菜品	汤羹	
乌鸡长寿面	汤面	主食	面	汤面
乌鸡馄饨汤	馄饨	主食	馄饨	
九层塔炒茄子	热菜	菜品	热菜	
九菜炒豆腐	热菜	菜品	热菜	
乡厨大拌菜	凉菜	菜品	凉菜	
乡村大烩菜	热菜	菜品	热菜	
乡村小炒柴火豆腐	热菜	菜品	热菜	
乡村疙瘩汤	汤羹	菜品	汤羹	
乡村茄子拌饭	盖浇饭	主食	饭	盖浇饭
乡村蘸酱菜	凉菜	菜品	凉菜	
乡野清新蘸酱菜	凉菜	菜品	凉菜	
乳鸽砂锅粥	粥	主食	粥	
乾隆娃娃菜	凉菜	菜品	凉菜	
二两白米饭	白米饭	主食	饭	白米饭
二代粉丝合菜	热菜	菜品	热菜	
二大娘大葱炒鸡蛋	热菜	菜品	热菜	
二大娘拌莜面	其他面	主食	面	其他面
二嫂疙瘩拌汤	汤羹	菜品	汤羹	
二白菜炒鹿茸菌	热菜	菜品	热菜	
二白菜炖土豆条	热菜	菜品	热菜	
二白菜炖豆腐	热菜	菜品	热菜	
二米南瓜粥	粥	主食	粥	
二荤二素一饭	其他菜品	其他	其他菜品	
二荤四素请选择两种荤菜	米线	主食	粉	米线
于掌勺大拌菜	凉菜	菜品	凉菜	
云南墨江紫米饭	白米饭	主食	饭	白米饭
云南翠绿生菜粥	粥	主食	粥	
云耳炒山药	热菜	菜品	热菜	
云耳百合炒山药	热菜	菜品	热菜	
云龙大拌菜	凉菜	菜品	凉菜	
五常原产稻花香米饭	白米饭	主食	饭	白米饭
五常大米米饭	白米饭	主食	饭	白米饭
五常大米饭	白米饭	主食	饭	白米饭
五常大米香米饭	白米饭	主食	饭	白米饭
五常珍珠香米饭	白米饭	主食	饭	白米饭
五常生态米饭	白米饭	主食	饭	白米饭
五常白米饭	白米饭	主食	饭	白米饭
五常稻花米饭	白米饭	主食	饭	白米饭
五常稻花香米饭	白米饭	其他	饭	白米饭
五常稻香米饭	白米饭	主食	饭	白米饭
五常精品米饭	白米饭	主食	饭	白米饭
五常红豆饭	焖饭	主食	饭	焖饭
五常长粒香米饭	白米饭	主食	饭	白米饭
五常香米饭	白米饭	主食	饭	白米饭
五常香米饭米饭	白米饭	主食	饭	白米饭
五彩大拌菜	凉菜	菜品	凉菜	
五彩小拌汤	汤羹	菜品	汤羹	
五彩时蔬粥	粥	主食	粥	
五彩炒粉丝	热菜	菜品	热菜	
五彩疙瘩汤	汤羹	菜品	汤羹	
五彩素营养粥	粥	主食	粥	
五指毛桃土茯苓排骨汤	汤羹	菜品	汤羹	
五指毛桃炖汤	汤羹	菜品	汤羹	
五指毛桃炖老火汤	汤羹	菜品	汤羹	
五指毛桃炖老鸡汤	汤羹	菜品	汤羹	
五星大拌菜	凉菜	菜品	凉菜	
五果冰糖粥	粥	主食	粥	
五福临门八宝粥	粥	主食	粥	
五种番茄浇汁莜面	拌面	主食	面	拌面
五花肉大白菜炖豆腐	热菜	菜品	热菜	
五花肉炖大白菜豆腐	热菜	菜品	热菜	
五花肉炖海带白菜豆腐	热菜	菜品	热菜	
五花肉炖白菜豆腐	热菜	菜品	热菜	
五荤二素一汤一饭	其他菜品	其他	其他菜品	
五行益寿养生粥	粥	主食	粥	
五谷丰登风味凉菜	凉菜	菜品	凉菜	
五谷丰登饭	盖浇饭	主食	饭	盖浇饭
五谷八宝粥	粥	主食	粥	
五谷杂粮养生粥	粥	主食	粥	
五谷杂粮稀饭	粥	主食	粥	
五谷杂粮粥	粥	主食	粥	
五谷杂粮补气粥	粥	主食	粥	
五谷杂粮饭	白米饭	色拉轻食	饭	白米饭
五谷精华小米粥	粥	主食	粥	
五谷红豆粥	粥	主食	粥	
五谷黑米粥	粥	主食	粥	
五香卷炒芹菜	热菜	菜品	热菜	
五香炒芹菜	热菜	菜品	热菜	
五香炒青椒	热菜	菜品	热菜	
五香豆沫粥	粥	主食	粥	
产妇西红柿鸡蛋面	汤面	主食	面	汤面
京味打卤面	盖浇面	主食	面	盖浇面
京味炒合菜	热菜	菜品	热菜	
京味炒红果	热菜	菜品	热菜	
京味炖带鱼	热菜	菜品	热菜	
京味疙瘩汤	汤羹	菜品	汤羹	
京味酸辣汤	汤羹	菜品	汤羹	
京嘴儿大拌菜	凉菜	菜品	凉菜	
京城味道丨豆泡汤	汤羹	菜品	汤羹	
京城手擀鸡蛋虾皮汆面	手擀面	主食	面	手擀面
京糕乾隆白菜	热菜	菜品	热菜	
京葱炒鸭丝	热菜	菜品	热菜	
京酱肉丝菠菜	热菜	菜品	热菜	
亲一定要点米饭	白米饭	主食	饭	白米饭
人人爱烤花菜	蔬菜类	烧烤	蔬菜类	
人参乌鸡汤	汤羹	菜品	汤羹	
人参大枣粥	粥	主食	粥	
人参山药鸽子煲汤	汤羹	菜品	汤羹	
人参鸽子汤	汤羹	菜品	汤羹	
人生百态咸菜豆腐汤	汤羹	菜品	汤羹	
什蔬蛋炒饭	炒饭	主食	饭	炒饭
什锦三鲜汤	汤羹	菜品	汤羹	
什锦压豆面	汤面	主食	面	汤面
什锦大拌菜	凉菜	菜品	凉菜	
什锦小拌菜	凉菜	菜品	凉菜	
什锦水果汤	其他甜品	甜点	其他甜品	
什锦水果热粥	粥	主食	粥	
什锦水果粥	粥	主食	粥	
什锦炒米粉	米线	主食	粉	米线
什锦炒素盖浇饭	盖浇饭	主食	饭	盖浇饭
什锦炒鲜蔬	热菜	菜品	热菜	
什锦素卤刀削面	其他面	主食	面	其他面
什锦素拌面	拌面	主食	面	拌面
什锦蔬菜咖喱饭	盖浇饭	主食	饭	盖浇饭
什锦蔬菜炒饭	炒饭	主食	饭	炒饭
什锦蔬菜粥	粥	主食	粥	
什锦蘑菇盖饭	盖浇饭	主食	饭	盖浇饭
什锦香葱蛋炒饭	炒饭	主食	饭	炒饭
什锦鱼丸汤	汤羹	菜品	汤羹	
什锦鲜蔬咖喱乌冬伴面	乌冬面	主食	面	乌冬面
什锦鲜蔬炒面	炒面	主食	面	炒面
仆豆角藕丁小碗菜	热菜	菜品	热菜	
今顺玉米温面	汤面	主食	面	汤面
介丝炒肉丝	热菜	菜品	热菜	
仙人姜汁核桃炖蛋	糖水/炖品	甜点	糖水/炖品	
伏尔加蔬菜汤	汤羹	菜品	汤羹	
众家炒合菜	热菜	菜品	热菜	
众稻八宝粥	粥	主食	粥	
优惠手撕包菜	热菜	菜品	热菜	
优质东北大米米饭	白米饭	主食	饭	白米饭
优质大米饭	白米饭	主食	饭	白米饭
优质小米南瓜粥	粥	主食	粥	
优质白米饭	白米饭	主食	饭	白米饭
优质素冒菜	其他菜品	其他	其他菜品	
优质菌菇冒菜	其他菜品	其他	其他菜品	
传家紫菜鱼丸汤	汤羹	菜品	汤羹	
传承古法腊八粥	粥	主食	粥	
传统八宝粥	粥	主食	粥	
传统刀削汤面	其他面	主食	面	其他面
传统刀削面	其他面	主食	面	其他面
传统大拌菜	凉菜	菜品	凉菜	
传统大碴粥	粥	主食	粥	
传统小米粥	粥	主食	粥	
传统手工面筋素胡辣汤	汤羹	菜品	汤羹	
传统手擀清汤面	手擀面	主食	面	手擀面
传统打卤面	盖浇面	主食	面	盖浇面
传统清汤面	汤面	主食	面	汤面
传统清炒虾仁	热菜	菜品	热菜	
传统炒三丝	热菜	菜品	热菜	
传统炒木须	热菜	菜品	热菜	
传统热汤面	汤面	主食	面	汤面
传统石锅蔬菜拌饭	拌饭	主食	饭	拌饭
传统素焖面	焖面	主食	面	焖面
传统芥菜饭	拌饭	主食	饭	拌饭
传统豆腐皮青菜	热菜	菜品	热菜	
传统酸辣汤	汤羹	菜品	汤羹	
传统鸡蛋汤	汤羹	菜品	汤羹	
伽师番茄炖牛肉	热菜	菜品	热菜	
低卡果蔬大拌菜	凉菜	菜品	凉菜	
低卡荞麦京酱面	其他面	主食	面	其他面
低卡荞麦鸡胸冷面	健康餐	色拉轻食	健康餐	
低卡鸡丝魔芋面	健康餐	色拉轻食	健康餐	
低油香葱炒鸡蛋	热菜	菜品	热菜	
低糖油茶面	饼干/曲奇	甜点	饼干/曲奇	
低糖莲子粥	粥	主食	粥	
低脂火腿韩式杂粮拌饭	拌饭	主食	饭	拌饭
低脂荞麦冷面	凉面	主食	面	凉面
低脂荞麦鸡蛋包菜鸡肉丝炒面	炒面	主食	面	炒面
低脂鸡腿饭	盖浇饭	主食	饭	盖浇饭
佬钱豌豆菜饭	焖饭	主食	饭	焖饭
佳人莲藕玉米排骨汤	汤羹	菜品	汤羹	
佳佳大米饭	白米饭	主食	饭	白米饭
佳木斯大拌菜	凉菜	菜品	凉菜	
例份西红柿炒蛋	热菜	菜品	热菜	
俄式传统罗宋汤	其他菜品	其他	其他菜品	
俄式罗宋汤	汤羹	菜品	汤羹	
俄罗斯罗宋汤	汤羹	菜品	汤羹	
俏姐醋溜白菜	热菜	菜品	热菜	
倒笃菜尖椒炒笋干	热菜	菜品	热菜	
倾情推荐丨外婆菜炒鸡蛋	热菜	菜品	热菜	
健体排骨粥	粥	主食	粥	
健康养胃小米粥	粥	主食	粥	
健康南瓜粥	粥	主食	粥	
健康大拌菜	凉菜	菜品	凉菜	
健康小米粥	粥	主食	粥	
健康小青菜	浇头	其他	浇头	
健康清肺菜	热菜	菜品	热菜	
健康炒杂蔬	热菜	菜品	热菜	
健康田园粥	粥	主食	粥	
健康的生菜	蔬菜类	火锅/串串/麻辣烫/色拉自选	配菜	蔬菜类
健康绿豆粥	粥	主食	粥	
健康营养大头菜	凉菜	菜品	凉菜	
健康蔬菜粥	粥	主食	粥	
健康蘸酱菜	凉菜	菜品	凉菜	
健康青菜粥	粥	主食	粥	
健胃小米南瓜粥	粥	主食	粥	
健胃小米粥	粥	主食	粥	
健脾养胃粥	粥	主食	粥	
健脾小米粥	粥	主食	粥	
傻四茄丁面	盖浇面	主食	面	盖浇面
元气奶香乌冬面	乌冬面	主食	面	乌冬面
元气小米粥	粥	主食	粥	
元气竹丝鸡汤	汤羹	菜品	汤羹	
元白菜炒窝头	热菜	菜品	热菜	
元盅鸡汤面	汤面	主食	面	汤面
元葱炒鸡蛋	热菜	菜品	热菜	
元葱鸡蛋盖饭	盖浇饭	主食	饭	盖浇饭
光炒小青菜	热菜	菜品	热菜	
免费海带汤	汤羹	菜品	汤羹	
免费的黑米粥稀饭	粥	主食	粥	
免费紫菜蛋汤	汤羹	菜品	汤羹	
党参乌鸡汤	汤羹	菜品	汤羹	
党参土鸡汤	汤羹	菜品	汤羹	
党参怀山土鸡汤	汤羹	菜品	汤羹	
党参枸杞茶树菇猪心汤	汤羹	菜品	汤羹	
党参枸杞莲子猪肚汤	汤羹	菜品	汤羹	
党参桃仁乌鸡汤	汤羹	菜品	汤羹	
党参猪心汤	汤羹	菜品	汤羹	
党参瘦肉汤	汤羹	菜品	汤羹	
党参红枣乌鸡汤	汤羹	菜品	汤羹	
党参萝卜排骨汤	汤羹	菜品	汤羹	
党参鸡腿汤	汤羹	菜品	汤羹	
党参鹌鹑煨汤	汤羹	菜品	汤羹	
入会专享皮蛋瘦肉粥	粥	主食	粥	
全仔杯装小米粥	粥	主食	粥	
全家福粗粮面	汤面	主食	面	汤面
全家福老鸭粉丝汤	其他粉	主食	粉	其他粉
全得利大拌菜	凉菜	菜品	凉菜	
全瘦芸豆双拼饭	其他主食	主食	其他主食	
全素套餐饭	其他菜品	其他	其他菜品	
全素煲仔饭	煲仔饭	主食	饭	煲仔饭
全素盖浇饭	盖浇饭	主食	饭	盖浇饭
全素石锅拌饭	拌饭	主食	饭	拌饭
全素菜盒饭	其他饭	主食	饭	其他饭
全素铁板炒面	炒面	主食	面	炒面
全素青菜拼米饭	盖浇饭	主食	饭	盖浇饭
全素韩式拌饭	拌饭	主食	饭	拌饭
全部素菜一种荤菜	米线	主食	粉	米线
全部素菜三种荤菜	米线	主食	粉	米线
全部素菜两种荤菜	米线	主食	粉	米线
全麦罗勒酱意大利面	意大利面	主食	面	意大利面
八大碗炖海带	热菜	菜品	热菜	
八宝养生粥	粥	主食	粥	
八宝咸菜粥	粥	主食	粥	
八宝山珍野菌汤	汤羹	菜品	汤羹	
八宝杂粮粥	粥	主食	粥	
八宝粥八宝粥八宝粥	粥	主食	粥	
八宝莲子粥	粥	主食	粥	
八宝菜咸粥	粥	主食	粥	
八宝黑米粥	粥	主食	粥	
八方养生粥	粥	主食	粥	
八方来财生菜	蔬菜类	火锅/串串/麻辣烫/色拉自选	配菜	蔬菜类
八旗炒合菜	热菜	菜品	热菜	
八珍豆腐加一盒米饭	其他菜品	其他	其他菜品	
八珍豆腐小碗菜	热菜	菜品	热菜	
八珍豆腐饭	盖浇饭	主食	饭	盖浇饭
六物秋梨汤	其他甜品	甜点	其他甜品	
六禾八宝粥	粥	主食	粥	
六荤二素一汤	其他饭	主食	饭	其他饭
兰州灰豆粥	粥	主食	粥	
兰州特色浆水面	汤面	主食	面	汤面
兰溪老鸭汤	汤羹	菜品	汤羹	
兰溪香干炒肉	热菜	菜品	热菜	
兰花玉菇炒虾仁	热菜	菜品	热菜	
关东木耳炒蛋	热菜	菜品	热菜	
关东煮娃娃菜	蔬菜类	烧烤	蔬菜类	
关中大烩菜	热菜	菜品	热菜	
关里家炖菜	热菜	菜品	热菜	
兹补乌鱼汤	汤羹	菜品	汤羹	
养元黑米粥	粥	主食	粥	
养生乌米饭	焖饭	主食	饭	焖饭
养生乳鸽汤	汤羹	菜品	汤羹	
养生五谷饭	健康餐	色拉轻食	健康餐	
养生什菌汤	汤羹	菜品	汤羹	
养生什锦小炒	热菜	菜品	热菜	
养生八宝粥	粥	主食	粥	
养生南瓜小米粥	粥	主食	粥	
养生南瓜砂锅粥	粥	主食	粥	
养生南瓜粥	粥	主食	粥	
养生原味小米粥	粥	主食	粥	
养生四宝菜	热菜	菜品	热菜	
养生土鸡汤	汤羹	菜品	汤羹	
养生地瓜粥	粥	主食	粥	
养生大拌菜	凉菜	菜品	凉菜	
养生大盆菜	热菜	菜品	热菜	
养生大碴粥	粥	主食	粥	
养生小炒什锦	热菜	菜品	热菜	
养生小白菜	蔬菜类	火锅/串串/麻辣烫/色拉自选	配菜	蔬菜类
养生小米南瓜粥	粥	主食	粥	
养生小米粥	粥	主食	粥	
养生小米红糖粥	粥	主食	粥	
养生山药粥	粥	主食	粥	
养生排骨汤	汤羹	菜品	汤羹	
养生排骨粥	粥	主食	粥	
养生时蔬大拌菜	凉菜	菜品	凉菜	
养生时蔬小炒	热菜	菜品	热菜	
养生滋补肉丸汤	汤羹	菜品	汤羹	
养生牛肉小面	汤面	主食	面	汤面
养生牛肉面	汤面	主食	面	汤面
养生猪肚粥	粥	主食	粥	
养生猪肚鸡汤	汤羹	菜品	汤羹	
养生白米粥	粥	主食	粥	
养生粗粮小米南瓜粥	粥	主食	粥	
养生粗粮小米粥	粥	主食	粥	
养生粥加小菜	粥	主食	粥	
养生糊糊粥	粥	主食	粥	
养生红薯粥	粥	主食	粥	
养生红豆粥	粥	主食	粥	
养生绿豆粥	粥	主食	粥	
养生肉丸汤	汤羹	菜品	汤羹	
养生草鸡汤	汤羹	菜品	汤羹	
养生荷叶粥	粥	主食	粥	
养生菌汤面	汤面	主食	面	汤面
养生菌皇汤面	汤面	主食	面	汤面
养生菌菇汤	汤羹	菜品	汤羹	
养生菌菇粥	粥	主食	粥	
养生菌菇素汤	汤羹	菜品	汤羹	
养生菌菇蛋花汤	汤羹	菜品	汤羹	
养生菌菇面	盖浇面	主食	面	盖浇面
养生菌菇鸡汤	汤羹	菜品	汤羹	
养生葛根甜汤	糖水/炖品	甜点	糖水/炖品	
养生蔬菜粥	粥	主食	粥	
养生虾皮白菜旮瘩汤	汤羹	菜品	汤羹	
养生裙带菜	凉菜	菜品	凉菜	
养生豆腐丸子汤	汤羹	菜品	汤羹	
养生豆花汤	汤羹	菜品	汤羹	
养生野菜粥	粥	主食	粥	
养生银耳汤	糖水/炖品	甜点	糖水/炖品	
养生青菜咸鸭蛋粥	粥	主食	粥	
养生骨汤面	汤面	主食	面	汤面
养生鱼丸汤	汤羹	菜品	汤羹	
养生鸡丝粥	粥	主食	粥	
养生鸡汤面	汤面	主食	面	汤面
养生鸽子汤	汤羹	菜品	汤羹	
养生黑米粥	粥	主食	粥	
养生黑鱼汤	汤羹	菜品	汤羹	
养生黑鱼煲汤	汤羹	菜品	汤羹	
养生龙骨山药汤	汤羹	菜品	汤羹	
养肝金线莲乳鸽花胶汤	汤羹	菜品	汤羹	
养胃丨小米粥	粥	主食	粥	
养胃丨疙瘩汤	汤羹	菜品	汤羹	
养胃八宝粥	粥	主食	粥	
养胃南瓜小米粥	粥	主食	粥	
养胃南瓜粥	粥	主食	粥	
养胃地瓜粥	粥	主食	粥	
养胃小米南瓜粥	粥	主食	粥	
养胃小米玉米粥	粥	主食	粥	
养胃小米粥	粥	其他	粥	
养胃暖心小米粥	粥	主食	粥	
养胃燕麦粥	粥	主食	粥	
养胃猪肚汤	汤羹	菜品	汤羹	
养胃猪肚面	盖浇面	主食	面	盖浇面
养胃玉米粥	粥	主食	粥	
养胃疙瘩汤	汤羹	菜品	汤羹	
养胃白米粥	粥	主食	粥	
养胃的现熬皮蛋瘦肉粥	粥	主食	粥	
养胃粗粮小米粥	粥	主食	粥	
养胃红糖小米粥	粥	主食	粥	
养胃纯小米粥	粥	主食	粥	
养胃青菜粥	粥	主食	粥	
养胃鱼片粥	粥	主食	粥	
养胃黑米粥	粥	主食	粥	
养血小米粥	粥	主食	粥	
养身乌鸡汤	汤羹	菜品	汤羹	
养身五黑粥	粥	主食	粥	
养身八宝粥	粥	主食	粥	
养身紫米粥	粥	主食	粥	
养颜乌鸡汤	汤羹	菜品	汤羹	
养颜八宝粥	粥	主食	粥	
养颜南瓜粥	粥	主食	粥	
养颜红米粥	粥	主食	粥	
养颜茄汁面	汤面	主食	面	汤面
养颜黑米粥	粥	主食	粥	
内脂豆腐汤	汤羹	菜品	汤羹	
再加一份匠心米饭	白米饭	主食	饭	白米饭
再加一份棕香米饭	白米饭	主食	饭	白米饭
再来一碗香米饭	白米饭	主食	饭	白米饭
冒什锦蔬菜	其他菜品	其他	其他菜品	
冒冒什锦菜	其他菜品	其他	其他菜品	
农历菱角粥	粥	主食	粥	
农夫小白菜	热菜	菜品	热菜	
农夫山泉煲米饭	白米饭	主食	饭	白米饭
农家一品炖豆腐	热菜	菜品	热菜	
农家一锅炖	热菜	菜品	热菜	
农家三鲜汤	汤羹	菜品	汤羹	
农家南瓜粥	粥	主食	粥	
农家四季豆外婆菜炒肉末	热菜	菜品	热菜	
农家地瓜粥	粥	主食	粥	
农家外婆菜	热菜	菜品	热菜	
农家大拌菜	凉菜	菜品	凉菜	
农家大杂菜	热菜	菜品	热菜	
农家大烩菜	热菜	菜品	热菜	
农家娃娃菜	蔬菜类	火锅/串串/麻辣烫/色拉自选	配菜	蔬菜类
农家小拌菜	凉菜	菜品	凉菜	
农家小炒瘦肉饭	盖浇饭	主食	饭	盖浇饭
农家小炒菜花	热菜	菜品	热菜	
农家小炒藕	热菜	菜品	热菜	
农家小炒藕片	热菜	菜品	热菜	
农家小炒豆角	热菜	菜品	热菜	
农家小炖菜小份	热菜	菜品	热菜	
农家小炖菜时蔬双拼套餐	其他菜品	其他	其他菜品	
农家小白菜	热菜	菜品	热菜	
农家小米粥	粥	主食	粥	
农家小青菜	蔬菜类	火锅/串串/麻辣烫/色拉自选	配菜	蔬菜类
农家小青菜炒千张	热菜	菜品	热菜	
农家手撕菜	凉菜	菜品	凉菜	
农家拌莜面	其他面	主食	面	其他面
农家木桶白米饭	白米饭	主食	饭	白米饭
农家毛圆汤	汤羹	菜品	汤羹	
农家毛白菜	热菜	菜品	热菜	
农家浆水菜	热菜	菜品	热菜	
农家炒丝瓜	热菜	菜品	热菜	
农家炒合菜	热菜	菜品	热菜	
农家炒合菜送三张烙馍	热菜	菜品	热菜	
农家炒小土豆	热菜	菜品	热菜	
农家炒木耳	热菜	菜品	热菜	
农家炒白菜	热菜	菜品	热菜	
农家炒粉丝	热菜	菜品	热菜	
农家炒粉条小份	热菜	菜品	热菜	
农家炒豆腐	热菜	菜品	热菜	
农家炒香干	热菜	菜品	热菜	
农家炖柴火豆腐	热菜	菜品	热菜	
农家炖柴鸡	热菜	菜品	热菜	
农家炖豆腐	热菜	菜品	热菜	
农家炖鱼砂锅	热菜	菜品	热菜	
农家炖黄瓜	热菜	菜品	热菜	
农家特色蒸菜	热菜	菜品	热菜	
农家疙瘩汤	汤羹	菜品	汤羹	
农家瘦肉汤	汤羹	菜品	汤羹	
农家白米饭	白米饭	主食	饭	白米饭
农家石蘑豆花汤	汤羹	菜品	汤羹	
农家笋干炒肉	热菜	菜品	热菜	
农家笋干盖浇饭	热菜	菜品	热菜	
农家素小炒	热菜	菜品	热菜	
农家红薯汤	汤羹	菜品	汤羹	
农家红薯粥	粥	主食	粥	
农家肉末炒芥菜丝	热菜	菜品	热菜	
农家臊子面	汤面	主食	面	汤面
农家草鸡汤	汤羹	菜品	汤羹	
农家菠菜面	拌面	主食	面	拌面
农家蒜苗炒鸡蛋	热菜	菜品	热菜	
农家蒸粉汤	汤羹	菜品	汤羹	
农家蒸野菜	热菜	菜品	热菜	
农家蘸酱菜	凉菜	菜品	凉菜	
农家虾皮疙瘩汤	汤羹	菜品	汤羹	
农家豆腐盖饭	盖浇饭	主食	饭	盖浇饭
农家过年菜	热菜	菜品	热菜	
农家雪菜炒土鸡蛋	热菜	菜品	热菜	
农家鸭肉粥	粥	主食	粥	
农家鹅蛋炒大葱	热菜	菜品	热菜	
农科院干锅花菜	热菜	菜品	热菜	
冬季喝点山药瘦肉粥	粥	主食	粥	
冬掩莱炒肉丝	热菜	菜品	热菜	
冬瓜丸子汤	汤羹	菜品	汤羹	
冬瓜丸子粉丝汤	其他粉	主食	粉	其他粉
冬瓜元子汤	汤羹	菜品	汤羹	
冬瓜小公鸡汤	汤羹	菜品	汤羹	
冬瓜小排汤	汤羹	菜品	汤羹	
冬瓜川圆汤	汤羹	菜品	汤羹	
冬瓜干贝汤	汤羹	菜品	汤羹	
冬瓜弯弯汤	汤羹	菜品	汤羹	
冬瓜弯骨汤	汤羹	菜品	汤羹	
冬瓜手工瘦肉丸子汤	汤羹	菜品	汤羹	
冬瓜排骨汤	汤羹	菜品	汤羹	
冬瓜排骨汤泡饭	泡饭	主食	饭	泡饭
冬瓜排骨煨汤	汤羹	菜品	汤羹	
冬瓜排骨瓦罐汤	汤羹	菜品	汤羹	
冬瓜枸杞大枣炖鸡汤	汤羹	菜品	汤羹	
冬瓜榨菜汤	其他面	主食	面	其他面
冬瓜海带排骨汤	汤羹	菜品	汤羹	
冬瓜海带汤	汤羹	菜品	汤羹	
冬瓜海螺汤	汤羹	菜品	汤羹	
冬瓜炒苦瓜	热菜	菜品	热菜	
冬瓜炒虾仁	热菜	菜品	热菜	
冬瓜炒虾皮	热菜	菜品	热菜	
冬瓜炖小排	热菜	菜品	热菜	
冬瓜炖排骨	热菜	菜品	热菜	
冬瓜炖排骨汤	汤羹	菜品	汤羹	
冬瓜猪手汤	汤羹	菜品	汤羹	
冬瓜猪肉丸子汤	汤羹	菜品	汤羹	
冬瓜玉米排骨汤	汤羹	菜品	汤羹	
冬瓜瘦肉丸子汤	汤羹	菜品	汤羹	
冬瓜瘦肉疙瘩汤	汤羹	菜品	汤羹	
冬瓜皮旦汤	汤羹	菜品	汤羹	
冬瓜皮蛋汤	汤羹	菜品	汤羹	
冬瓜皮蛋鱼片汤	汤羹	菜品	汤羹	
冬瓜粉条炖肉	热菜	菜品	热菜	
冬瓜老鸭汤	汤羹	菜品	汤羹	
冬瓜老鸭汤泡饭	泡饭	主食	饭	泡饭
冬瓜肉丝汤	汤羹	菜品	汤羹	
冬瓜肉丸子汤	热菜	菜品	热菜	
冬瓜肉丸汤	汤羹	菜品	汤羹	
冬瓜肉元汤	汤羹	菜品	汤羹	
冬瓜肉沫汤	汤羹	菜品	汤羹	
冬瓜肉片汤	汤羹	菜品	汤羹	
冬瓜肚片汤	汤羹	菜品	汤羹	
冬瓜花蛤汤	汤羹	菜品	汤羹	
冬瓜薏仁剔骨肉汤	汤羹	菜品	汤羹	
冬瓜薏米汤	汤羹	菜品	汤羹	
冬瓜虾仁汤	汤羹	菜品	汤羹	
冬瓜虾米汤	汤羹	菜品	汤羹	
冬瓜蛋花汤	汤羹	菜品	汤羹	
冬瓜蛤蜊汤	汤羹	菜品	汤羹	
冬瓜软骨米饭	盖浇饭	主食	饭	盖浇饭
冬瓜青菜海带汤	汤羹	菜品	汤羹	
冬瓜骨头汤	汤羹	菜品	汤羹	
冬瓜鲫鱼汤	汤羹	菜品	汤羹	
冬笋水芥菜	热菜	菜品	热菜	
冬笋虾肉面	汤面	主食	面	汤面
冬菇滑鸡粥	粥	主食	粥	
冬菇红豆莲子炖猪肚	汤羹	菜品	汤羹	
冬菜笋炒毛豆	热菜	菜品	热菜	
冬菜肉丝豆腐面	汤面	主食	面	汤面
冰冻八宝粥	粥	主食	粥	
冰冻银耳汤	糖水/炖品	甜点	糖水/炖品	
冰城蘸酱菜	凉菜	菜品	凉菜	
冰湖野米海参粥	粥	主食	粥	
冰爽裙带菜	凉菜	菜品	凉菜	
冰糖八宝粥	粥	主食	粥	
冰糖南瓜粥	粥	主食	粥	
冰糖地瓜粥	粥	主食	粥	
冰糖小米南瓜粥	粥	主食	粥	
冰糖枸杞炖雪梨	其他甜品	甜点	其他甜品	
冰糖枸杞红糖大枣粥	粥	主食	粥	
冰糖桂圆八宝粥	粥	主食	粥	
冰糖桂花雪梨粥	粥	主食	粥	
冰糖炖秋梨	其他菜品	其他	其他菜品	
冰糖炖银耳	糖水/炖品	甜点	糖水/炖品	
冰糖炖雪梨	其他甜品	甜点	其他甜品	
冰糖炖雪梨炖雪耳	其他甜品	甜点	其他甜品	
冰糖煨梨汤	其他甜品	甜点	其他甜品	
冰糖百合炖银耳	糖水/炖品	甜点	糖水/炖品	
冰糖百合炖雪梨	其他甜品	甜点	其他甜品	
冰糖百合芦荟粥	粥	主食	粥	
冰糖紫薯粥	粥	主食	粥	
冰糖红枣粥	粥	主食	粥	
冰糖红枣红豆粥	粥	主食	粥	
冰糖红枣莲子银耳粥	粥	主食	粥	
冰糖红梨汤	其他甜品	甜点	其他甜品	
冰糖红豆粥	粥	主食	粥	
冰糖绿豆百合汤	糖水/炖品	甜点	糖水/炖品	
冰糖绿豆粥	粥	主食	粥	
冰糖荷叶粥	粥	主食	粥	
冰糖莲子八宝粥	粥	主食	粥	
冰糖莲子汤	糖水/炖品	甜点	糖水/炖品	
冰糖莲子百合绿豆炖鹌鹑蛋	糖水/炖品	甜点	糖水/炖品	
冰糖银耳大枣粥	粥	主食	粥	
冰糖银耳汤	糖水/炖品	甜点	糖水/炖品	
冰糖银耳炖木瓜	其他甜品	甜点	其他甜品	
冰糖银耳炖雪梨	其他甜品	甜点	其他甜品	
冰糖银耳粥	糖水/炖品	甜点	糖水/炖品	
冰糖银耳莲子汤	糖水/炖品	甜点	糖水/炖品	
冰糖银耳雪梨汤	其他甜品	甜点	其他甜品	
冰糖银耳雪梨粥	粥	甜点	粥	
冰糖银耳雪梨莲子粥	粥	主食	粥	
冰糖雪梨汤	其他甜品	甜点	其他甜品	
冰糖雪梨炖银耳	其他甜品	甜点	其他甜品	
冰糖雪梨煨汤	其他甜品	甜点	其他甜品	
冰糖雪梨百合汤	其他甜品	甜点	其他甜品	
冰糖雪梨粥	粥	主食	粥	
冰糖雪梨红枣莲子百合汤	其他甜品	甜点	其他甜品	
冰糖雪梨银耳汤	其他甜品	甜点	其他甜品	
冰糖雪梨银耳百合粥	粥	主食	粥	
冰糖雪梨银耳粥	粥	主食	粥	
冰糖雪梨鲜炖燕窝	其他甜品	甜点	其他甜品	
冰糖雪耳炖雪梨	其他甜品	甜点	其他甜品	
冰糖鲜炖燕窝	其他甜品	甜点	其他甜品	
冰糖黑米粥	粥	主食	粥	
冰银耳莲子汤	糖水/炖品	甜点	糖水/炖品	
冰镇百合绿豆汤	糖水/炖品	甜点	糖水/炖品	
冰镇绿豆百合汤	糖水/炖品	菜品	糖水/炖品	
冰镇绿豆粥	粥	主食	粥	
冰镇银耳汤	糖水/炖品	甜点	糖水/炖品	
冲绳风炒苦瓜	热菜	菜品	热菜	
冷面加点香菜	凉面	主食	面	凉面
冷面荞麦面	凉面	主食	面	凉面
冻豆腐炖牛肉小份	热菜	菜品	热菜	
冻豆腐炖白菜	热菜	菜品	热菜	
冻豆腐炖酸菜粉条	热菜	菜品	热菜	
冻豆腐酸菜	热菜	菜品	热菜	
净化水南瓜银耳粥	粥	主食	粥	
净化水小米粥	粥	主食	粥	
净化水皮蛋瘦肉粥	粥	主食	粥	
凉拌下火菜	凉菜	菜品	凉菜	
凉拌云丝面	拌面	主食	面	拌面
凉拌包心菜	凉菜	菜品	凉菜	
凉拌圆白菜	凉菜	菜品	凉菜	
凉拌大头菜	凉菜	菜品	凉菜	
凉拌娃娃菜	凉菜	菜品	凉菜	
凉拌手撕包菜	热菜	菜品	热菜	
凉拌灰灰菜	凉菜	菜品	凉菜	
凉拌空心菜	凉菜	菜品	凉菜	
凉拌素素菜	凉菜	菜品	凉菜	
凉拌紫包菜	凉菜	菜品	凉菜	
凉拌腐竹芹菜	凉菜	菜品	凉菜	
凉拌荞麦面	拌面	主食	面	拌面
凉拌裙带菜	凉菜	菜品	凉菜	
凉拌豆芽菜	凉菜	菜品	凉菜	
凉拌青干菜	凉菜	菜品	凉菜	
凉拌龙须菜	凉菜	菜品	凉菜	
凉瓜炒牛肉	热菜	菜品	热菜	
凉瓜炒蛋饭	盖浇饭	主食	饭	盖浇饭
凉瓜炒鸡蛋饭	盖浇饭	主食	饭	盖浇饭
凉瓜肉片饭	盖浇饭	主食	饭	盖浇饭
凉瓜鸡蛋饭	木桶饭	主食	饭	木桶饭
凉皮不放香菜	凉皮	主食	凉皮	
凉皮卷素菜	凉皮	主食	凉皮	
凉皮拌花菜	凉皮	主食	凉皮	
凉粉炒鸡蛋	其他粉	主食	粉	其他粉
减脂香煎鸡排炒蛋沙拉	健康餐	色拉轻食	健康餐	
刀削打卤面	其他面	主食	面	其他面
刀削热汤面	其他面	主食	面	其他面
刀削面不辣的葱油面	其他面	主食	面	其他面
刀削鸡蛋面	其他面	主食	面	其他面
刀豆炒土豆	热菜	菜品	热菜	
刀豆炒肉丝	热菜	菜品	热菜	
刀豆炒茄子	热菜	菜品	热菜	
刀鱼扒白菜	热菜	菜品	热菜	
刀鱼烧白菜	热菜	菜品	热菜	
刘老根蘸酱菜	凉菜	菜品	凉菜	
初榨橄榄油大拌菜	凉菜	菜品	凉菜	
别忘了米饭	白米饭	主食	饭	白米饭
别忘记米饭	白米饭	主食	饭	白米饭
刮油棒渣粥	粥	主食	粥	
刷酱洋白菜	蔬菜类	火锅/串串/麻辣烫/色拉自选	配菜	蔬菜类
剁椒大白菜	热菜	菜品	热菜	
剁椒豆芽菜	热菜	菜品	热菜	
剔骨牛肉汤	汤羹	菜品	汤羹	
剔骨肉炖白菜	热菜	菜品	热菜	
功夫炖鲤鱼	热菜	菜品	热菜	
功夫皮蛋瘦肉粥	粥	主食	粥	
加一个炒鸡蛋	浇头	其他	浇头	
加一人份小油菜	浇头	其他	浇头	
加一份娃娃菜	浇头	其他	浇头	
加一份水果玉米粒炒在饭里	浇头	其他	浇头	
加一份油菜炒进去	浇头	其他	浇头	
加一份海菜	浇头	其他	浇头	
加一份炖土豆	浇头	其他	浇头	
加一份炖蛋	浇头	其他	浇头	
加一份熟玉米粒一起炒	浇头	其他	浇头	
加一份牛心菜	热菜	菜品	热菜	
加一份玉米粒炒在饭里	浇头	其他	浇头	
加一份生菜	浇头	其他	浇头	
加一份白菜	浇头	其他	浇头	
加一份米饭	白米饭	主食	饭	白米饭
加一份菠菜	浇头	其他	浇头	
加一份营养豆芽菜炒在饭里	浇头	其他	浇头	
加一份葱炒在饭里	浇头	其他	浇头	
加一份豆干炒在饭里	热菜	菜品	热菜	
加一份豆芽炒在主食里	浇头	其他	浇头	
加一份青菜	蔬菜类	火锅/串串/麻辣烫/色拉自选	配菜	蔬菜类
加一份黄花菜	浇头	其他	浇头	
加一小份白菜	浇头	其他	浇头	
加一整份新鲜的娃娃菜炒在饭里	浇头	其他	浇头	
加一点香菜	蔬菜类	火锅/串串/麻辣烫/色拉自选	配菜	蔬菜类
加一盒小青菜	蔬菜类	火锅/串串/麻辣烫/色拉自选	配菜	蔬菜类
加一碗东北米饭	白米饭	主食	饭	白米饭
加一碗清汤	汤羹	菜品	汤羹	
加东北五常香米饭	白米饭	主食	饭	白米饭
加个鸡蛋在糁汤	浇头	其他	浇头	
加份小青菜	浇头	其他	浇头	
加份新鲜喷香香米饭	白米饭	主食	饭	白米饭
加份水煮青菜	浇头	其他	浇头	
加份油麦菜	蔬菜类	火锅/串串/麻辣烫/色拉自选	配菜	蔬菜类
加份青椒一起炒	浇头	其他	浇头	
加卤蛋不带米饭	浇头	其他	浇头	
加小份青菜	蔬菜类	火锅/串串/麻辣烫/色拉自选	配菜	蔬菜类
加手工刀削面	其他面	主食	面	其他面
加料一青菜	蔬菜类	火锅/串串/麻辣烫/色拉自选	配菜	蔬菜类
加点小青菜	蔬菜类	火锅/串串/麻辣烫/色拉自选	配菜	蔬菜类
加玉米粒炒	浇头	其他	浇头	
加番茄炒蛋	浇头	其他	浇头	
加糖南瓜粥	粥	主食	粥	
加绿色小青菜	热菜	菜品	热菜	
加菜娃娃菜	蔬菜类	火锅/串串/麻辣烫/色拉自选	配菜	蔬菜类
加菜老鸭汤	汤羹	菜品	汤羹	
加蛋番茄手擀面	手擀面	主食	面	手擀面
加蛋老鸭汤	汤羹	菜品	汤羹	
加蛋蔬菜面	汤面	主食	面	汤面
加豆干炒进去	热菜	菜品	热菜	
加香干切碎炒	浇头	其他	浇头	
加香干炒进去	浇头	其他	浇头	
加鲜嫩小白菜	蔬菜类	火锅/串串/麻辣烫/色拉自选	配菜	蔬菜类
加鲜炒虾仁	浇头	其他	浇头	
加鲜烫青菜	蔬菜类	菜品	配菜	蔬菜类
加鸡蛋蛋花汤	汤羹	菜品	汤羹	
勾肉炖豆腐中	热菜	菜品	热菜	
勾肉炖豆腐大	热菜	菜品	热菜	
包包菜炒囊	其他主食	主食	其他主食	
包包菜炒馕	其他主食	主食	其他主食	
包心菜炒粉丝	热菜	菜品	热菜	
包心菜牛肉炒粉丝	热菜	菜品	热菜	
包心菜豆腐汤	汤羹	菜品	汤羹	
包菜炒东北粉	热菜	菜品	热菜	
包菜炒油皮	热菜	菜品	热菜	
包菜炒粉丝	热菜	菜品	热菜	
包菜炒粉条	热菜	菜品	热菜	
包菜炒肉丝	热菜	菜品	热菜	
包菜炒豆面	炒面	主食	面	炒面
包菜炒鸡蛋	热菜	菜品	热菜	
包菜粉丝炒蛋	热菜	菜品	热菜	
包菜粉丝炒鸡蛋	热菜	菜品	热菜	
包菜粉条盖浇饭	盖浇饭	主食	饭	盖浇饭
包菜鸡蛋炒粉丝	热菜	菜品	热菜	
北极贝肉丝粥	粥	主食	粥	
北江状元及第粥	粥	主食	粥	
十个锅贴一个鸡蛋送个粥	其他菜品	其他	其他菜品	
十五元牛肉汤	汤羹	菜品	汤羹	
十珍八包粥	粥	主食	粥	
十珍八宝粥	粥	主食	粥	
千口顺大拌菜	凉菜	菜品	凉菜	
千叶豆腐小炒	热菜	菜品	热菜	
千叶豆腐炒肉	热菜	菜品	热菜	
千叶豆腐炒虾仁	热菜	菜品	热菜	
千叶豆腐盖浇饭	盖浇饭	主食	饭	盖浇饭
千叶豆腐盖饭	盖浇饭	主食	饭	盖浇饭
千层卷炒芹菜	热菜	菜品	热菜	
千岛湖梅干菜	凉菜	菜品	凉菜	
千张包粉丝汤	其他粉	主食	粉	其他粉
千张卷香菜	蔬菜类	烧烤	蔬菜类	
千张小白菜	热菜	菜品	热菜	
千张炒小白菜	热菜	菜品	热菜	
千张炒肉丝	热菜	菜品	热菜	
千张炒韭菜	热菜	菜品	热菜	
千张粉丝汤	其他粉	主食	粉	其他粉
千张肉丝小碗菜	热菜	菜品	热菜	
千里香馄炖	馄饨	主食	馄饨	
千页豆腐盖饭	盖浇饭	主食	饭	盖浇饭
升级西红柿鸡蛋汤面	汤面	主食	面	汤面
半份二米饭	白米饭	主食	饭	白米饭
半份什锦菜	热菜	菜品	热菜	
半份小豆饭	焖饭	主食	饭	焖饭
半份小锅饭大拌菜	拌饭	主食	饭	拌饭
半份拌花菜	凉菜	菜品	凉菜	
半份木耳炒肉	热菜	菜品	热菜	
半份杭椒炒蛋	热菜	菜品	热菜	
半份炒合菜	热菜	菜品	热菜	
半份生炒菜花	热菜	菜品	热菜	
半份疙瘩汤	汤羹	菜品	汤羹	
半份白米饭	白米饭	主食	饭	白米饭
半份菌类小炒	热菜	菜品	热菜	
半份蒜蓉油麦菜	热菜	菜品	热菜	
半份西兰花小炒	热菜	菜品	热菜	
半份西红柿炒蛋	热菜	菜品	热菜	
半份西红柿炒鸡蛋	热菜	菜品	热菜	
半份韭菜炒鸡蛋	热菜	菜品	热菜	
半份香菇扒油菜	热菜	菜品	热菜	
半份黄瓜炒鸡蛋	热菜	菜品	热菜	
半荤加素拼盒饭	其他饭	主食	饭	其他饭
华子磨炒小白菜	热菜	菜品	热菜	
单人份皮蛋瘦肉粥	粥	主食	粥	
单人份豆角焖面	焖面	主食	面	焖面
单人干贝虾粥	粥	主食	粥	
单人混合涮菜	其他菜品	其他	其他菜品	
单人滑鸡粥	粥	主食	粥	
单人纯素冒菜	其他菜品	其他	其他菜品	
单人蘑菇粥	粥	主食	粥	
单人虾蟹粥	粥	主食	粥	
单人鲜虾粥	粥	主食	粥	
单份豆芽菜	热菜	菜品	热菜	
单加一份秘制炒酸菜	热菜	菜品	热菜	
单加娃娃菜	蔬菜类	火锅/串串/麻辣烫/色拉自选	配菜	蔬菜类
单加小青菜	浇头	其他	浇头	
单加时令蔬菜	浇头	其他	浇头	
单加油麦菜	浇头	其他	浇头	
单加白宽面	其他菜品	其他	其他菜品	
单加白米饭	白米饭	主食	饭	白米饭
单加的米饭	白米饭	主食	饭	白米饭
单县小鱼汤	汤羹	菜品	汤羹	
单点一个米饭	白米饭	主食	饭	白米饭
单点一份角瓜炒鸡蛋	热菜	菜品	热菜	
单点一大份家常凉菜	凉菜	菜品	凉菜	
单点一大份炒三丝	热菜	菜品	热菜	
单点外婆菜炒土鸡蛋	热菜	菜品	热菜	
单点套餐蔬菜	热菜	菜品	热菜	
单点白米饭	白米饭	主食	饭	白米饭
单独豆腐汤不带米饭	其他小吃	小吃	其他小吃	
单鸡蛋糁汤	汤羹	菜品	汤羹	
南乳炒莲藕	热菜	菜品	热菜	
南乳炒藕片	热菜	菜品	热菜	
南乳空心菜	热菜	菜品	热菜	
南京老鸭粉丝汤	其他粉	主食	粉	其他粉
南北杏无花果炖猪展	汤羹	菜品	汤羹	
南北杏炖雪梨热	其他甜品	甜点	其他甜品	
南塘美人米炒河虾仁	热菜	菜品	热菜	
南昌炒三丝	热菜	菜品	热菜	
南瓜加焖面	焖面	主食	面	焖面
南瓜地瓜粥	粥	主食	粥	
南瓜大枣小米粥	粥	主食	粥	
南瓜大米粥	粥	主食	粥	
南瓜小碴粥	粥	主食	粥	
南瓜小米养生粥	粥	主食	粥	
南瓜小米枸杞粥	粥	主食	粥	
南瓜小米稀饭	粥	主食	粥	
南瓜小米粥	粥	主食	粥	
南瓜小米红枣粥	粥	主食	粥	
南瓜小米营养粥	粥	主食	粥	
南瓜山药粥	粥	主食	粥	
南瓜构杞粥	粥	主食	粥	
南瓜枸杞小米粥	粥	主食	粥	
南瓜枸杞粥	粥	主食	粥	
南瓜栗子粥	粥	主食	粥	
南瓜江米粥	粥	主食	粥	
南瓜炒碱鸭蛋	热菜	菜品	热菜	
南瓜炒虾皮	热菜	菜品	热菜	
南瓜燕麦粥	粥	主食	粥	
南瓜玉米粥	粥	主食	粥	
南瓜番薯粥	粥	主食	粥	
南瓜百合粥	粥	主食	粥	
南瓜粥爱上小菜	粥	主食	粥	
南瓜粥饼泡包菜	馅饼	主食	饼/囊/馍	馅饼
南瓜糯米粥	粥	主食	粥	
南瓜红枣小米粥	粥	主食	粥	
南瓜红枣汤	糖水/炖品	菜品	糖水/炖品	
南瓜红枣粥	粥	主食	粥	
南瓜红薯粥	粥	主食	粥	
南瓜红豆粥	粥	主食	粥	
南瓜绿豆粥	粥	主食	粥	
南瓜莲子粥	粥	主食	粥	
南瓜蔬菜粥	粥	主食	粥	
南瓜薏仁小米粥	粥	主食	粥	
南瓜薏米粥	粥	主食	粥	
南瓜蚝干饭	焖饭	主食	饭	焖饭
南瓜银耳枸杞粥	粥	主食	粥	
南瓜银耳汤	糖水/炖品	甜点	糖水/炖品	
南瓜银耳粥	粥	主食	粥	
南瓜黑米粥	粥	主食	粥	
南粳香米饭	白米饭	主食	饭	白米饭
南肖墙丸子汤	汤羹	菜品	汤羹	
卜奎大拌菜	凉菜	菜品	凉菜	
卜留克炒豆芽	凉菜	菜品	凉菜	
卜豆角炒藕丝	热菜	菜品	热菜	
卤味豆腐丝炒肉	热菜	菜品	热菜	
卤水豆腐拌面	拌面	主食	面	拌面
卤水豆腐汤	汤羹	菜品	汤羹	
卤蛋蔬菜面	汤面	主食	面	汤面
卤豆腐丸子面	盖浇面	主食	面	盖浇面
卷心菜炒番茄	热菜	菜品	热菜	
卷心菜炒粉丝	热菜	菜品	热菜	
卷心菜炒粉条	热菜	菜品	热菜	
卷心菜炒肉	热菜	菜品	热菜	
卷心菜红萝卜菜饭	盖浇饭	主食	饭	盖浇饭
卷心菜菜饭	其他菜品	其他	其他菜品	
卷心菜鸡蛋炒粉丝	热菜	菜品	热菜	
压锅丰收菜	热菜	菜品	热菜	
厚弥鲜虾粥	粥	主食	粥	
原只椰子炖竹丝鸡	热菜	菜品	热菜	
原只椰子炖鹌鹑汤	汤羹	菜品	汤羹	
原只雪梨汤	其他甜品	甜点	其他甜品	
原味二米粥	粥	主食	粥	
原味刀削面	其他面	主食	面	其他面
原味南瓜粥	粥	主食	粥	
原味参鸡汤	汤羹	菜品	汤羹	
原味土鸡暖汤	汤羹	菜品	汤羹	
原味大碴粥	粥	主食	粥	
原味大米粥	粥	主食	粥	
原味小米南瓜粥	粥	主食	粥	
原味小米稀饭	粥	主食	粥	
原味小米粥	粥	主食	粥	
原味手工米粉汤	米线	主食	粉	米线
原味清新紫菜包饭	其他饭	主食	饭	其他饭
原味清汤面	汤面	主食	面	汤面
原味牛肉汤	汤羹	菜品	汤羹	
原味玉米粥	粥	主食	粥	
原味玉米面	汤面	主食	面	汤面
原味珍菌汤	汤羹	菜品	汤羹	
原味番茄土蛋汤	汤羹	菜品	汤羹	
原味疙瘩汤	汤羹	菜品	汤羹	
原味粿条汤	米线	主食	粉	米线
原味紫菜包饭	寿司	主食	饭	其他饭
原味绿豆粥	粥	主食	粥	
原味老火鸭架汤	汤羹	菜品	汤羹	
原味荞麦面	汤面	主食	面	汤面
原味萝卜汤	汤羹	菜品	汤羹	
原味豆汤饭	泡饭	主食	饭	泡饭
原味饺子清汤	汤羹	菜品	汤羹	
原味黑米粥	粥	主食	粥	
原汁原味小米粥	粥	主食	粥	
原汁原味稀饭	粥	主食	粥	
原汁小米粥	粥	主食	粥	
原汁山菌汤	汤羹	菜品	汤羹	
原汁老鸭汤	汤羹	菜品	汤羹	
原汁鸡蛋柿子面	汤面	主食	面	汤面
原汤手工面	手擀面	主食	面	手擀面
原汤素粉面	汤面	主食	面	汤面
原汤蘑菇面	汤面	主食	面	汤面
原汤鲫鱼面	汤面	主食	面	汤面
原点鸡汤泡饭	泡饭	主食	饭	泡饭
原生态大拌菜	凉菜	菜品	凉菜	
原盅乌鸡汤	汤羹	菜品	汤羹	
原盅五指毛桃炖猪肺汤	汤羹	菜品	汤羹	
原盅凉瓜黄豆炖排骨汤	汤羹	菜品	汤羹	
原盅猪肚汤	汤羹	菜品	汤羹	
原盅老鸭汤	汤羹	菜品	汤羹	
原盅蒸白饭	白米饭	主食	饭	白米饭
原盅鸽子汤	汤羹	菜品	汤羹	
原谷小米粥	粥	主食	粥	
厦门一品粥	粥	主食	粥	
去根松花菜	热菜	菜品	热菜	
参丝薏米鸽子汤	汤羹	菜品	汤羹	
参片乌鸡汤	汤羹	菜品	汤羹	
参片鸽子汤	汤羹	菜品	汤羹	
参芪乌鸡汤	汤羹	菜品	汤羹	
又香又糯白米粥	粥	主食	粥	
双义特色手擀面	手擀面	主食	面	手擀面
双人份土鸡猪肚粥	粥	主食	粥	
双人份土鸡瘦肉粥	粥	主食	粥	
双人份干贝虾鲍鱼粥	粥	主食	粥	
双人份干贝鲍鱼蟹粥	粥	主食	粥	
双人干贝鲜虾砂锅粥	粥	主食	粥	
双拼香菇滑鸡菜	煲仔饭	主食	饭	煲仔饭
双料老鸭粉丝汤	其他粉	主食	粉	其他粉
双来打卤面	盖浇面	主食	面	盖浇面
双耳乌鸡汤	汤羹	菜品	汤羹	
双菇炒笋片	热菜	菜品	热菜	
双菇炒肉片	热菜	菜品	热菜	
双菇面筋面	汤面	主食	面	汤面
双菇鱼片面	汤面	主食	面	汤面
双蛋紫菜汤	汤羹	菜品	汤羹	
双蛋紫菜鸡蛋汤	汤羹	菜品	汤羹	
双鲜粉丝娃娃菜	热菜	菜品	热菜	
口味有机花菜	热菜	菜品	热菜	
口味炒香干	热菜	菜品	热菜	
口蘑小白菜	热菜	菜品	热菜	
口蘑油麦菜	热菜	菜品	热菜	
口蘑炒塔菜	热菜	菜品	热菜	
口蘑炒毛白菜	热菜	菜品	热菜	
口蘑裙带菜嫩豆腐汤	汤羹	菜品	汤羹	
古味乾隆白菜	凉菜	菜品	凉菜	
古方秘制八宝粥	粥	主食	粥	
古法八宝粥	粥	主食	粥	
古法冰糖八宝粥	粥	主食	粥	
古法四红粥	粥	主食	粥	
古法泉水香米白饭	白米饭	主食	饭	白米饭
古法熬制八宝粥	粥	主食	粥	
古法熬制的小米粥	粥	主食	粥	
古法红豆汤	糖水/炖品	甜点	糖水/炖品	
古龙小米粥	粥	主食	粥	
另加一份小白菜	浇头	其他	浇头	
另加一份油菜	浇头	其他	浇头	
另加娃娃菜	其他粉	主食	粉	其他粉
另加小份青菜	浇头	其他	浇头	
另加小白菜	浇头	其他	浇头	
另加油麦菜	蔬菜类	火锅/串串/麻辣烫/色拉自选	配菜	蔬菜类
另加烫生菜	浇头	其他	浇头	
另加裙带菜	浇头	其他	浇头	
可口脆瓜小菜	凉菜	菜品	凉菜	
可口黄瓜咸菜	凉菜	菜品	凉菜	
可爱白米粥	粥	主食	粥	
台山丝苗米饭	盖浇饭	主食	饭	盖浇饭
台式茄子饭	盖浇饭	主食	饭	盖浇饭
台湾冰镇八宝粥	粥	主食	粥	
台湾小白菜	热菜	菜品	热菜	
台灣高麗菜	热菜	菜品	热菜	
史记荞麦冷面	凉面	主食	面	凉面
各式炒青菜	热菜	菜品	热菜	
各种拌素菜	凉菜	菜品	凉菜	
各种时令蔬菜	热菜	菜品	热菜	
合叶饼加菜	夹饼/夹馍	主食	饼/囊/馍	夹饼/夹馍
合记鸡蛋木耳烩捞面	其他面	主食	面	其他面
吉妈妈打卤面	盖浇面	主食	面	盖浇面
吉妈妈经典打卤面	盖浇面	主食	面	盖浇面
同州豆腐菜	凉菜	菜品	凉菜	
吱味南瓜粥	粥	主食	粥	
吴弟山野菜汤	汤羹	菜品	汤羹	
吴弟山野菜面	汤面	主食	面	汤面
告诉老默我想吃鱼了巴沙鱼单人餐鱼豆腐丸子娃娃菜金针菇米饭	其他菜品	其他	其他菜品	
呛炒圆白菜	热菜	菜品	热菜	
呛炒土豆片	热菜	菜品	热菜	
味噌豆腐汤	汤羹	菜品	汤羹	
味增炒蔬菜	热菜	菜品	热菜	
和食海裙菜	凉菜	菜品	凉菜	
咱妈大拌菜	凉菜	菜品	凉菜	
咱家疙瘩汤	汤羹	菜品	汤羹	
咱家香米饭	白米饭	主食	饭	白米饭
咸味皮蛋瘦肉粥	粥	主食	粥	
咸白菜小炒	热菜	菜品	热菜	
咸白菜炒肉片	热菜	菜品	热菜	
咸白菜炒豆芽	热菜	菜品	热菜	
咸白菜炒鸡蛋	热菜	菜品	热菜	
咸白菜炖春笋	热菜	菜品	热菜	
咸白菜白玉菇炒肉丝	热菜	菜品	热菜	
咸白菜豆付汤	汤羹	菜品	汤羹	
咸笋老鸭汤	汤羹	菜品	汤羹	
咸糯皮蛋瘦肉粥	粥	主食	粥	
咸肉冬瓜扁尖汤	汤羹	菜品	汤羹	
咸肉冬瓜汤	汤羹	菜品	汤羹	
咸肉炒冬瓜	热菜	菜品	热菜	
咸菜冬瓜汤	汤羹	菜品	汤羹	
咸菜炒冬笋	热菜	菜品	热菜	
咸菜炒春笋	热菜	菜品	热菜	
咸菜炒绿豆芽	热菜	菜品	热菜	
咸菜炒茄子	热菜	菜品	热菜	
咸菜炒蘑菇	热菜	菜品	热菜	
咸菜炒豆干	热菜	菜品	热菜	
咸菜炒豆腐干	热菜	菜品	热菜	
咸菜炒鸡蛋	热菜	菜品	热菜	
咸菜肉丝豆腐汤	汤羹	菜品	汤羹	
咸菜荞麦面	汤面	主食	面	汤面
咸菜蘑菇炒肉丝	热菜	菜品	热菜	
咸菜豆干饭	盖浇饭	主食	饭	盖浇饭
咸菜豆腐干炒肉丝	热菜	菜品	热菜	
咸菜豆腐汤	汤羹	菜品	汤羹	
咸菜豆芽菜	热菜	菜品	热菜	
咸菜马铃薯汤	汤羹	菜品	汤羹	
咸菜黑鱼骨面	汤面	主食	面	汤面
咸蛋炒苦瓜	热菜	菜品	热菜	
咸蛋生菜粥	粥	主食	粥	
咸蛋瘦肉粥	粥	主食	粥	
咸蛋菜心粥	粥	主食	粥	
咸蛋青菜粥	粥	主食	粥	
咸蛋黄蔬菜粥	粥	主食	粥	
咸香娃娃菜	热菜	菜品	热菜	
咸骨皮蛋粥	粥	主食	粥	
咸骨肉丸粥	粥	主食	粥	
咸鲜皮蛋蔬菜粥	粥	主食	粥	
咸鲜蔬菜粥	粥	主食	粥	
咸鲞豆腐汤	汤羹	菜品	汤羹	
咸黄瓜炒肉	热菜	菜品	热菜	
喜爱的小青菜	浇头	其他	浇头	
喷儿香米饭	白米饭	主食	饭	白米饭
喷喷香大米饭	白米饭	主食	饭	白米饭
喷喷香米饭	白米饭	主食	饭	白米饭
喷香喷香的白米饭	白米饭	主食	饭	白米饭
喷香大米饭	白米饭	主食	饭	白米饭
喷香白米饭	白米饭	主食	饭	白米饭
嘎嘎香米饭	白米饭	主食	饭	白米饭
嘎牙鱼炖东北粉条	热菜	菜品	热菜	
囊炒圆白菜	热菜	菜品	热菜	
四个素菜盒饭	其他饭	主食	饭	其他饭
四个鸡蛋的番茄炒蛋	热菜	菜品	热菜	
四件炒豆芽	热菜	菜品	热菜	
四季豆榄菜	热菜	菜品	热菜	
四季豆清炒	热菜	菜品	热菜	
四季豆炒土豆	热菜	菜品	热菜	
四季豆炒肉	热菜	菜品	热菜	
四季豆炒肉丝	热菜	菜品	热菜	
四季豆炒肉末	热菜	菜品	热菜	
四季豆炒肉沫	热菜	菜品	热菜	
四季豆炒肉片	热菜	菜品	热菜	
四季豆肉丝饭十送例汤	其他菜品	其他	其他菜品	
四季豆鸡蛋炒饭	炒饭	主食	饭	炒饭
四季鲜蔬汤面	汤面	主食	面	汤面
四小时茶树菇煨老鸡汤	汤羹	菜品	汤羹	
四川大拌菜	凉菜	菜品	凉菜	
四海大拌菜	凉菜	菜品	凉菜	
四物老鸭汤	汤羹	菜品	汤羹	
四红养生粥	粥	主食	粥	
四色缤纷紫米粥	粥	主食	粥	
回忆西红柿炒鸡蛋	热菜	菜品	热菜	
回记特色清炖牛肉	汤羹	菜品	汤羹	
固原特色炒麻食	炒面	主食	面	炒面
圆圆的圆白菜	蔬菜类	火锅/串串/麻辣烫/色拉自选	配菜	蔬菜类
圆生菜丨低脂素菜	蔬菜类	火锅/串串/麻辣烫/色拉自选	配菜	蔬菜类
圆白菜木耳爆豆腐饭	盖浇饭	主食	饭	盖浇饭
圆白菜炒粉	热菜	菜品	热菜	
圆白菜炒粉丝	热菜	菜品	热菜	
圆白菜炒粉条	热菜	菜品	热菜	
圆白菜炒饼	其他主食	主食	其他主食	
圆白菜炒鸡蛋	热菜	菜品	热菜	
圆白菜粉丝炒鸡蛋	热菜	菜品	热菜	
圆白菜粉丝牛肉饭	盖浇饭	主食	饭	盖浇饭
圆白菜鸡蛋炒面	炒面	主食	面	炒面
圆盒白米饭	白米饭	主食	饭	白米饭
圆粗玉米面	其他菜品	其他	其他菜品	
圆葱木耳炒蛋	热菜	菜品	热菜	
圆葱木耳炒鸡蛋	热菜	菜品	热菜	
圆葱木耳鸡蛋盖饭	盖浇饭	主食	饭	盖浇饭
圆葱炒肉丝小份	热菜	菜品	热菜	
圆葱炒鸡蛋	热菜	菜品	热菜	
圆葱炒鸡蛋半份	热菜	菜品	热菜	
圆葱瓜片炒鸡蛋	热菜	菜品	热菜	
圆骨山药木耳清汤	汤羹	菜品	汤羹	
土家洋芋饭	盖浇饭	主食	饭	盖浇饭
土家炒香干	热菜	菜品	热菜	
土家蛋炒木耳	热菜	菜品	热菜	
土椒炒笨鸡蛋	热菜	菜品	热菜	
土猪肉白菜豆腐炒粉条	热菜	菜品	热菜	
土芹香干炒肉	热菜	菜品	热菜	
土茯苓薏米炖龙骨	汤羹	菜品	汤羹	
土豆丝伴面	拌面	主食	面	拌面
土豆丝清炒	热菜	菜品	热菜	
土豆丝炒瘦肉	热菜	菜品	热菜	
土豆丝炒肉	热菜	菜品	热菜	
土豆丝炒肉丝	热菜	菜品	热菜	
土豆丝炒肉煲	热菜	菜品	热菜	
土豆丝炒艽菜	热菜	菜品	热菜	
土豆丝炒芹菜	热菜	菜品	热菜	
土豆丝炒莜面	炒面	主食	面	炒面
土豆丝炒豆芽	热菜	菜品	热菜	
土豆丝炒酸菜	热菜	菜品	热菜	
土豆丝炒青椒	热菜	菜品	热菜	
土豆丝炒韭菜	热菜	菜品	热菜	
土豆丝炒饼	其他主食	主食	其他主食	
土豆丝炒鸡蛋	热菜	菜品	热菜	
土豆丝炒黄瓜丝	热菜	菜品	热菜	
土豆丝盖浇面	盖浇面	主食	面	盖浇面
土豆丝盖浇饭	盖浇饭	主食	饭	盖浇饭
土豆丝盖饭	盖浇饭	主食	饭	盖浇饭
土豆丝芹菜	热菜	菜品	热菜	
土豆丝豆嘴炒粉条	热菜	菜品	热菜	
土豆丝酸豆角卷生菜	热菜	菜品	热菜	
土豆丝韭菜炒鸡蛋	热菜	菜品	热菜	
土豆丝黄瓜丝炒蚬肉	热菜	菜品	热菜	
土豆干煸豆角饭	盖浇饭	主食	饭	盖浇饭
土豆条炖芹菜	热菜	菜品	热菜	
土豆条炖豆腐	热菜	菜品	热菜	
土豆条酸菜	热菜	菜品	热菜	
土豆泥小白菜	热菜	菜品	热菜	
土豆泥拌莜面	其他面	主食	面	其他面
土豆泥拌饭	拌饭	主食	饭	拌饭
土豆泥莜面	凉面	主食	面	凉面
土豆海带炖排骨	热菜	菜品	热菜	
土豆炒尖椒	热菜	菜品	热菜	
土豆炒山芹	热菜	菜品	热菜	
土豆炒牛肉	热菜	菜品	热菜	
土豆炒肉丝	热菜	菜品	热菜	
土豆炒肉片	热菜	菜品	热菜	
土豆炒酸菜	热菜	菜品	热菜	
土豆炒韭菜	热菜	菜品	热菜	
土豆炖柴鸡	热菜	菜品	热菜	
土豆炖牛肉	热菜	菜品	热菜	
土豆炖牛肉丨超烂糊	热菜	菜品	热菜	
土豆炖牛肉单人套餐	热菜	菜品	热菜	
土豆炖牛肉煲仔	煲仔饭	主食	饭	煲仔饭
土豆炖牛肉砂锅米饭	其他饭	主食	饭	其他饭
土豆炖芸豆	热菜	菜品	热菜	
土豆炖茄子	热菜	菜品	热菜	
土豆炖茄子酱	热菜	菜品	热菜	
土豆炖豆腐	热菜	菜品	热菜	
土豆炖豆角	热菜	菜品	热菜	
土豆炖鸡块	热菜	菜品	热菜	
土豆炖鸡腿	热菜	菜品	热菜	
土豆烧牛肉饭	盖浇饭	主食	饭	盖浇饭
土豆烧瘦肉片木桶饭	木桶饭	主食	饭	木桶饭
土豆烧芸豆盖浇饭	其他菜品	其他	其他菜品	
土豆烧芸豆盖饭	盖浇饭	主食	饭	盖浇饭
土豆烧豆角丨经典烧菜	热菜	菜品	热菜	
土豆烧豆角盖浇饭	盖浇饭	主食	饭	盖浇饭
土豆烧豆角盖饭	盖浇饭	主食	饭	盖浇饭
土豆烩小白菜	热菜	菜品	热菜	
土豆片炒尖椒	热菜	菜品	热菜	
土豆片炒杂拌蘑菇	热菜	菜品	热菜	
土豆片炒牛肉	热菜	菜品	热菜	
土豆片炒甘蓝	热菜	菜品	热菜	
土豆片炒瘦肉	热菜	菜品	热菜	
土豆片炒肉	热菜	菜品	热菜	
土豆片炒肉丝	热菜	菜品	热菜	
土豆片炒肉盖浇	盖浇饭	主食	饭	盖浇饭
土豆片炒肉盖浇饭	盖浇饭	主食	饭	盖浇饭
土豆片炒香菇	热菜	菜品	热菜	
土豆片炒鸡	热菜	菜品	热菜	
土豆片炒黄蘑	热菜	菜品	热菜	
土豆牛肉十米饭	其他菜品	其他	其他菜品	
土豆牛肉汤	汤羹	菜品	汤羹	
土豆牛肉饭	盖浇饭	主食	饭	盖浇饭
土豆粉炒鸡蛋	热菜	菜品	热菜	
土豆素炒饼	其他主食	主食	其他主食	
土豆肉丝盖浇饭	盖浇饭	主食	饭	盖浇饭
土豆肉丝饭	盖浇饭	主食	饭	盖浇饭
土豆腐炖千张	热菜	菜品	热菜	
土豆芸豆大锅菜	热菜	菜品	热菜	
土豆芸豆炖肉	热菜	菜品	热菜	
土豆芸豆面	汤面	主食	面	汤面
土豆茄子打卤面	盖浇面	主食	面	盖浇面
土豆茄子炖肉	热菜	菜品	热菜	
土豆菜干麦面	汤面	主食	面	汤面
土豆萝卜丝汤	汤羹	菜品	汤羹	
土豆豆角炒饭	炒饭	主食	饭	炒饭
土豆豆角焖面	焖面	主食	面	焖面
土豆豆角饭	盖浇饭	主食	饭	盖浇饭
土豆韭菜沫汤	汤羹	菜品	汤羹	
土豆香菇炖鸡块	热菜	菜品	热菜	
土豆骨头汤十米饭	其他菜品	其他	其他菜品	
土豆鸡丁饭十紫菜汤	其他菜品	其他	其他菜品	
土豆鸡块饭	盖浇饭	主食	饭	盖浇饭
土豆鸡蛋汤	汤羹	菜品	汤羹	
土鲫鱼豆腐汤	汤羹	菜品	汤羹	
土鸡滋补粥	粥	主食	粥	
土鸡炖萝卜汤	热菜	菜品	热菜	
土鸡炖针磨粉条	热菜	菜品	热菜	
土鸡猪肚汤	汤羹	菜品	汤羹	
土鸡虾粥粥	粥	主食	粥	
土鸡蛋炒槐花拨烂子	炒面	主食	面	炒面
土鸡蛋炒虾仁	热菜	菜品	热菜	
土鸡蛋蛋汤	汤羹	菜品	汤羹	
在骨头汤里面加一份鸡毛菜	浇头	其他	浇头	
地三鲜小份菜	热菜	菜品	热菜	
地三鲜小炒	热菜	菜品	热菜	
地三鲜小炒十米饭十汤饮料随机	其他菜品	其他	其他菜品	
地三鲜小菜	热菜	菜品	热菜	
地三鲜花饭	盖浇饭	主食	饭	盖浇饭
地中海风味粥	粥	主食	粥	
地产椒炒鸡蛋	热菜	菜品	热菜	
地瓜小米粥	粥	主食	粥	
地瓜燕麦粥	粥	主食	粥	
地瓜花生粥	粥	主食	粥	
地皮炒鸡蛋	热菜	菜品	热菜	
地皮菜炒土鸡蛋	热菜	菜品	热菜	
地皮菜炒蛋	热菜	菜品	热菜	
地皮菜炒鸡蛋	热菜	菜品	热菜	
地皮菜炒鹅蛋	热菜	菜品	热菜	
地皮菜烩窝菜	热菜	菜品	热菜	
地衣炒雪菜	热菜	菜品	热菜	
地软炒鸡蛋	热菜	菜品	热菜	
坛肉粉条小白菜	热菜	菜品	热菜	
坡上灰灰菜	热菜	菜品	热菜	
坪壤豆浆面	汤面	主食	面	汤面
垮炖大黄鱼	热菜	菜品	热菜	
城北大拌菜	凉菜	菜品	凉菜	
城隍庙小米绿豆粥	粥	主食	粥	
基础烤蔬菜美式自选盖浇饭	健康餐	色拉轻食	健康餐	
塑封杯蔬菜粥	粥	主食	粥	
塔菜炒冬笋	热菜	菜品	热菜	
塘鲺瘦肉粥	粥	主食	粥	
墨斗炒韭菜	热菜	菜品	热菜	
墨鱼丸砂锅粥	粥	主食	粥	
墨鱼炒白菜	热菜	菜品	热菜	
外卖手打鲜贝丸子汤	汤羹	菜品	汤羹	
外卖手撕包菜	热菜	菜品	热菜	
外卖木耳炒肉	热菜	菜品	热菜	
外卖果仁菠菜	凉菜	菜品	凉菜	
外卖白米饭	白米饭	主食	饭	白米饭
外卖稻花香米饭	白米饭	主食	饭	白米饭
外卖红烧肉烩豆腐白菜	热菜	菜品	热菜	
外卖茄子炖花蚬子	热菜	菜品	热菜	
外卖营养粥	粥	主食	粥	
外卖西红柿炒鸡蛋	热菜	菜品	热菜	
外卖香菇鸡肉盖饭	盖浇饭	主食	饭	盖浇饭
外卖鲜黄花菜炒鸡蛋	热菜	菜品	热菜	
外卖鸡蛋汤	汤羹	菜品	汤羹	
外婆下饭菜	热菜	菜品	热菜	
外婆八宝粥	粥	主食	粥	
外婆家乡菜炒鸡蛋	热菜	菜品	热菜	
外婆家的素面汤	汤面	主食	面	汤面
外婆炒三鲜	热菜	菜品	热菜	
外婆炒豆角	热菜	菜品	热菜	
外婆炒鸡蛋	热菜	菜品	热菜	
外婆疙瘩汤	汤羹	菜品	汤羹	
外婆菜小炒	热菜	菜品	热菜	
外婆菜干饭	焖饭	主食	饭	焖饭
外婆菜炒四季豆	热菜	菜品	热菜	
外婆菜炒土鸡蛋	热菜	菜品	热菜	
外婆菜炒柴鸡蛋	热菜	菜品	热菜	
外婆菜炒筒笋	热菜	菜品	热菜	
外婆菜炒肉	热菜	菜品	热菜	
外婆菜炒肉丝	热菜	菜品	热菜	
外婆菜炒肉末	热菜	菜品	热菜	
外婆菜炒肉沫	热菜	菜品	热菜	
外婆菜炒蛋	热菜	菜品	热菜	
外婆菜炒蛋十米饭	其他菜品	其他	其他菜品	
外婆菜炒蛋单人份	热菜	菜品	热菜	
外婆菜炒蛋小份	热菜	菜品	热菜	
外婆菜炒蛋盖饭	盖浇饭	主食	饭	盖浇饭
外婆菜炒豇豆	热菜	菜品	热菜	
外婆菜炒魔芋豆腐	热菜	菜品	热菜	
外婆菜炒鸡蛋	热菜	菜品	热菜	
外婆菜炒鸡蛋大份	热菜	菜品	热菜	
外婆菜炒鸡蛋小份	热菜	菜品	热菜	
外婆菜炒鸡蛋干	热菜	菜品	热菜	
外婆菜碎肉炒豆角	热菜	菜品	热菜	
外婆菜鸡蛋饭	木桶饭	主食	饭	木桶饭
外婆葱油拌面	拌面	主食	面	拌面
外尖椒丝炒土豆丝	热菜	菜品	热菜	
外爆炒甘蓝	热菜	菜品	热菜	
外稻花香米饭	白米饭	主食	饭	白米饭
外素炒土豆丝	热菜	菜品	热菜	
外高粱米粥	粥	主食	粥	
多加一个无菌鸡蛋炒在饭里	浇头	其他	浇头	
多加一份叶子菜	蔬菜类	火锅/串串/麻辣烫/色拉自选	配菜	蔬菜类
多加一份洋葱炒在饭里	浇头	其他	浇头	
多加一份生菜	浇头	菜品	浇头	
多加一份酸菜	浇头	其他	浇头	
多加份生菜	浇头	其他	浇头	
多加点青菜	浇头	其他	浇头	
多加豆芽菜	浇头	其他	浇头	
多彩八宝粥	粥	主食	粥	
多彩蔬菜粥	粥	主食	粥	
多谷物米饭	浇头	其他	浇头	
夜开花炒虾皮	热菜	菜品	热菜	
夜开花炒西红柿	热菜	菜品	热菜	
大东北合菜	热菜	菜品	热菜	
大丰收蘸酱菜	凉菜	菜品	凉菜	
大份冬瓜肋边排骨米饭	其他饭	主食	饭	其他饭
大份冬瓜肋边米饭	热菜	菜品	热菜	
大份土豆小白菜	热菜	菜品	热菜	
大份小米玉米粥	粥	主食	粥	
大份干锅花菜	热菜	菜品	热菜	
大份油麦菜	浇头	其他	浇头	
大份海带肋边米饭	其他菜品	其他	其他菜品	
大份清心绿豆粥	粥	主食	粥	
大份清炒西兰花	热菜	菜品	热菜	
大份燕麦粥	粥	主食	粥	
大份生炒菜花	热菜	菜品	热菜	
大份疙瘩汤	汤羹	菜品	汤羹	
大份白菜肋边米饭	热菜	菜品	热菜	
大份素卷饼自选三样小菜	卷饼	主食	饼/囊/馍	卷饼
大份素炒豆角丝	热菜	菜品	热菜	
大份紫米粥	粥	主食	粥	
大份肋边白菜	其他菜品	其他	其他菜品	
大份营养鸡汤	汤羹	菜品	汤羹	
大份虾仁汤	汤羹	菜品	汤羹	
大份豆角面	拌面	主食	面	拌面
大份酱香饼加小米粥	其他菜品	其他	其他菜品	
大份锅巴粥	粥	主食	粥	
大份鸡蛋汤	汤羹	菜品	汤羹	
大份黄焖鸡十豆皮十米饭	其他菜品	其他	其他菜品	
大份黄焖鸡千张油豆腐小青菜米饭	其他菜品	其他	其他菜品	
大力水手同款菠菜	蔬菜类	火锅/串串/麻辣烫/色拉自选	配菜	蔬菜类
大力水手爱菠菜	凉菜	菜品	凉菜	
大力水手菠菜	热菜	菜品	热菜	
大力水手菠菜牛肉蛋花粥	粥	主食	粥	
大厨手撕包菜	热菜	菜品	热菜	
大厨爽口白菜	热菜	菜品	热菜	
大块土豆炖牛肉	热菜	菜品	热菜	
大头卷心菜	浇头	其他	浇头	
大头菜炒肉丝	热菜	菜品	热菜	
大头菜炒虾皮	热菜	菜品	热菜	
大头菜番茄汤	汤羹	菜品	汤羹	
大头菜芹菜	其他包子	主食	包子	其他包子
大嫂炒合菜	热菜	菜品	热菜	
大家爱吃的白粥	粥	主食	粥	
大扇贝柱炒茭瓜	热菜	菜品	热菜	
大木桶蒸的白米饭	白米饭	主食	饭	白米饭
大枣养胃粥	粥	主食	粥	
大枣小米粥	粥	主食	粥	
大枣山药粥	粥	主食	粥	
大枣枸杞红糖小米粥	粥	主食	粥	
大枣枸杞红糖粥	粥	主食	粥	
大枣红糖地瓜粥	粥	主食	粥	
大枣红糖小米养生粥	粥	主食	粥	
大枣红糖小米粥	粥	主食	粥	
大枣红糖粥	粥	主食	粥	
大枣红豆粥	粥	主食	粥	
大枣银耳粥	粥	主食	粥	
大济宁酥肉炖白菜	热菜	菜品	热菜	
大白菜凉菜	凉菜	菜品	凉菜	
大白菜打卤面	盖浇面	主食	面	盖浇面
大白菜炒圆圆粿	热菜	菜品	热菜	
大白菜炒木耳	热菜	菜品	热菜	
大白菜炒油泡	热菜	菜品	热菜	
大白菜炒油豆泡	热菜	菜品	热菜	
大白菜炒粉丝	热菜	菜品	热菜	
大白菜炒粉小份	米线	主食	粉	米线
大白菜炒粉条	热菜	菜品	热菜	
大白菜炒肉	热菜	菜品	热菜	
大白菜炒肉丝	热菜	菜品	热菜	
大白菜炒豆油皮	热菜	菜品	热菜	
大白菜炒豆泡	热菜	菜品	热菜	
大白菜炒豆皮	热菜	菜品	热菜	
大白菜炒面筋	热菜	菜品	热菜	
大白菜炖元子	热菜	菜品	热菜	
大白菜炖冻豆腐	热菜	菜品	热菜	
大白菜炖大豆腐	热菜	菜品	热菜	
大白菜炖干豆腐	热菜	菜品	热菜	
大白菜炖水豆腐	热菜	菜品	热菜	
大白菜炖海带	热菜	菜品	热菜	
大白菜炖海带黄豆	热菜	菜品	热菜	
大白菜炖豆腐	热菜	菜品	热菜	
大白菜炖豆腐粉条	热菜	菜品	热菜	
大白菜炖豆腐肉	热菜	菜品	热菜	
大白菜炖软豆腐	热菜	菜品	热菜	
大白菜炖鲜贝	热菜	菜品	热菜	
大白菜猪肉炖粉丝	热菜	菜品	热菜	
大白菜粉条炖豆腐	热菜	菜品	热菜	
大白菜肉片饭	盖浇饭	主食	饭	盖浇饭
大白菜豆腐汤	汤羹	菜品	汤羹	
大白菜豆腐炖比管鱼	热菜	菜品	热菜	
大白菜豆腐炖粉条	热菜	菜品	热菜	
大白菜豆腐粉条肉炖	热菜	菜品	热菜	
大盆有机花菜	热菜	菜品	热菜	
大盆木耳有机花菜	热菜	菜品	热菜	
大盘炒素菜	热菜	菜品	热菜	
大碗三鲜鸡蛋汤	汤羹	菜品	汤羹	
大碗八宝粥	粥	主食	粥	
大碗农家花菜	热菜	菜品	热菜	
大碗冰镇绿豆百合粥	粥	主食	粥	
大碗南瓜小米粥	粥	主食	粥	
大碗南瓜山药粥	粥	主食	粥	
大碗小米南瓜粥	粥	主食	粥	
大碗小米枸杞粥	粥	主食	粥	
大碗小米玉米粥	粥	主食	粥	
大碗小米粥	粥	主食	粥	
大碗有机花菜	热菜	菜品	热菜	
大碗枸杞小米粥	粥	主食	粥	
大碗清热绿豆粥	粥	主食	粥	
大碗炒散菜花	热菜	菜品	热菜	
大碗疙瘩汤	汤羹	菜品	汤羹	
大碗白米饭	白米饭	主食	饭	白米饭
大碗皮蛋瘦肉粥	粥	主食	粥	
大碗紫米莲子粥	粥	主食	粥	
大碗紫菜蛋花汤	汤羹	菜品	汤羹	
大碗红糖养胃粥	粥	主食	粥	
大碗红豆薏米粥	粥	主食	粥	
大碗绿豆百合粥	粥	主食	粥	
大碗老鸭粉丝汤	其他粉	主食	粉	其他粉
大碗腊八粥	粥	主食	粥	
大碗茄丁土豆丁盖饭	盖浇饭	主食	饭	盖浇饭
大碗西红柿鸡蛋面	汤面	主食	面	汤面
大碗香香米饭	白米饭	主食	饭	白米饭
大碗鲜炒菜花	热菜	菜品	热菜	
大碴子芸豆粥	粥	主食	粥	
大祘炒素肠	热菜	菜品	热菜	
大米南瓜玉米粒粥	粥	主食	粥	
大米南瓜粥	粥	菜品	粥	
大米小米粥	粥	主食	粥	
大米小馇子稀饭	粥	主食	粥	
大米皮蛋粥	粥	主食	粥	
大米红枣粥	粥	主食	粥	
大米红糖红枣粥	粥	主食	粥	
大米红豆粥	粥	主食	粥	
大米绿豆玉米粥	粥	主食	粥	
大米绿豆粥	粥	主食	粥	
大米荷叶粥	粥	主食	粥	
大米蔬菜粥	粥	主食	粥	
大米黑米粥	粥	主食	粥	
大自然鱼蕨菜	蔬菜类	火锅/串串/麻辣烫/色拉自选	配菜	蔬菜类
大葱木耳炒蛋	热菜	菜品	热菜	
大葱木耳炒鸡蛋	热菜	菜品	热菜	
大葱油饼十南瓜粥	其他菜品	其他	其他菜品	
大葱炒双蛋	热菜	菜品	热菜	
大葱炒木耳	热菜	菜品	热菜	
大葱炒木耳小份	热菜	菜品	热菜	
大葱炒肉一盘	热菜	菜品	热菜	
大葱炒肉片	热菜	菜品	热菜	
大葱炒蛋盖浇饭	盖浇饭	主食	饭	盖浇饭
大葱炒豆腐	热菜	菜品	热菜	
大葱炒鸡蛋	热菜	菜品	热菜	
大葱炒鸡蛋卷	卷饼	主食	饼/囊/馍	卷饼
大葱炒鸡蛋炒菜	热菜	菜品	热菜	
大葱炒鸡蛋盖饭	盖浇饭	主食	饭	盖浇饭
大葱豆腐盖饭	盖浇饭	主食	饭	盖浇饭
大葱酱炒鸡蛋	热菜	菜品	热菜	
大葱鸡蛋十米饭	其他菜品	其他	其他菜品	
大葱鸡蛋小炒十米饭	其他菜品	其他	其他菜品	
大葱鸡蛋炒馒头	炒面	主食	面	炒面
大葱鸡蛋盖浇饭	盖浇饭	主食	饭	盖浇饭
大葱鸡蛋盖饭	盖浇饭	主食	饭	盖浇饭
大蒜千张炒肉丝	热菜	菜品	热菜	
大蒜叶炒瘦肉丝	热菜	菜品	热菜	
大蒜叶炒肉丝	热菜	菜品	热菜	
大蒜叶炒肉片	热菜	菜品	热菜	
大蒜叶炒豆腐皮	热菜	菜品	热菜	
大蒜叶炒香干	热菜	菜品	热菜	
大蒜炒卤藕	热菜	菜品	热菜	
大蒜炒干丝	热菜	菜品	热菜	
大蒜炒平菇	热菜	菜品	热菜	
大蒜炒白干	热菜	菜品	热菜	
大蒜炒素肠	热菜	菜品	热菜	
大蒜炒肉丝	热菜	菜品	热菜	
大蒜炒茶干	热菜	菜品	热菜	
大蒜炒豆丝	热菜	菜品	热菜	
大蒜炒豆干	热菜	菜品	热菜	
大蒜炒香干	热菜	菜品	热菜	
大蒜炒香干肉丝	热菜	菜品	热菜	
大蒜炒鸡蛋	热菜	菜品	热菜	
大蒜笋干炒肉	热菜	菜品	热菜	
大蒜苗炒白干	热菜	菜品	热菜	
大蒜苗炒肉丝	热菜	菜品	热菜	
大蒜苗炒香干	热菜	菜品	热菜	
大虾炒白菜	热菜	菜品	热菜	
大虾烧白菜	热菜	菜品	热菜	
大豆瓣炒肉	热菜	菜品	热菜	
大豆腐炖土豆条	热菜	菜品	热菜	
大豆芽炒粉条	热菜	菜品	热菜	
大豆芽炒肉丝	热菜	菜品	热菜	
大辣椒炒芹菜	热菜	菜品	热菜	
大辣椒炒芹菜一份	热菜	菜品	热菜	
大酱小葱末炒蛋	热菜	菜品	热菜	
大酱炒鸡蛋	热菜	菜品	热菜	
大酱炒鸡蛋小份	热菜	菜品	热菜	
大酱鸡蛋小份菜	热菜	菜品	热菜	
大锅炒豆腐	热菜	菜品	热菜	
大锅炖芸豆	热菜	菜品	热菜	
大饼夹炒鸡蛋	夹饼/夹馍	主食	饼/囊/馍	夹饼/夹馍
大饼炒鸡蛋	其他主食	主食	其他主食	
大馇粥小咸菜	粥	主食	粥	
大骨头海带汤	汤羹	菜品	汤羹	
大骨汤炖豆腐	热菜	菜品	热菜	
大骨海带汤	汤羹	菜品	汤羹	
大骨紫菜蛋花汤	汤羹	菜品	汤羹	
大骨萝卜汤	汤羹	菜品	汤羹	
大骨驴清汤	汤羹	菜品	汤羹	
大鱼头豆腐汤	汤羹	菜品	汤羹	
大鲫鱼青菜豆腐汤	汤羹	菜品	汤羹	
大麦小枣山药粥	粥	主食	粥	
大麦小枣铁棍山药粥	粥	主食	粥	
大麦山药粥	粥	主食	粥	
大麦红枣山药粥	粥	主食	粥	
大麦红枣粥	粥	主食	粥	
大黄蚬子煮小白菜	热菜	菜品	热菜	
天外手撕菜	热菜	菜品	热菜	
天天海白菜	凉菜	菜品	凉菜	
天津卫打卤面	盖浇面	主食	面	盖浇面
天津绿小白菜	热菜	菜品	热菜	
天然绿油油的生菜	蔬菜类	火锅/串串/麻辣烫/色拉自选	配菜	蔬菜类
天目笋干小炒	热菜	菜品	热菜	
天麻乌鸡汤	汤羹	菜品	汤羹	
天麻乳鸽汤	汤羹	菜品	汤羹	
天麻瘦肉炖竹丝鸡	汤羹	菜品	汤羹	
天麻老鸭汤	汤羹	菜品	汤羹	
天麻花旗参炖鸽子	汤羹	菜品	汤羹	
天麻莲子乌鸡汤	汤羹	菜品	汤羹	
天麻鸽子汤	汤羹	菜品	汤羹	
太子私房藕汤	汤羹	菜品	汤羹	
太湖大米饭	白米饭	主食	饭	白米饭
太煲油麦菜	热菜	菜品	热菜	
头水紫菜汤	汤羹	菜品	汤羹	
头菜炒粉丝小份	热菜	菜品	热菜	
头菜粉条炒肉丝	热菜	菜品	热菜	
夹炒土豆丝	热菜	菜品	热菜	
套餐娃娃菜	蔬菜类	火锅/串串/麻辣烫/色拉自选	配菜	蔬菜类
女士枣莲粥	粥	主食	粥	
女士营养枣莲粥	粥	主食	粥	
女性养颜粥	粥	主食	粥	
女汉子的白米饭	白米饭	主食	饭	白米饭
女神四物汤	汤羹	菜品	汤羹	
奶油南瓜汤	汤羹	菜品	汤羹	
奶油南瓜浓汤	汤羹	菜品	汤羹	
奶油小白菜	蔬菜类	火锅/串串/麻辣烫/色拉自选	配菜	蔬菜类
奶白菜炒豆皮	热菜	菜品	热菜	
奶香南瓜粥	粥	主食	粥	
奶香山药粥	粥	主食	粥	
奶香燕麦粥	粥	主食	粥	
奶香玉米汤	汤羹	菜品	汤羹	
奶香玉米浓汤	汤羹	菜品	汤羹	
奶香蘑菇汤	汤羹	菜品	汤羹	
好人一生平安活杀大鲫鱼豆腐汤	汤羹	菜品	汤羹	
好吃白米饭	白米饭	主食	饭	白米饭
好吃的娃娃菜	蔬菜类	火锅/串串/麻辣烫/色拉自选	配菜	蔬菜类
好吃的疙瘩汤	汤羹	菜品	汤羹	
好吃的米饭	白米饭	主食	饭	白米饭
好喝的黑米粥	粥	主食	粥	
好嫂子大拌菜	凉菜	菜品	凉菜	
好运来炖菜	热菜	菜品	热菜	
妈妈乌冬面	乌冬面	主食	面	乌冬面
妈妈味炖牛肉	热菜	菜品	热菜	
妈妈大拌菜	凉菜	菜品	凉菜	
妈妈小炒花菜	热菜	菜品	热菜	
妈妈小炒菜花	热菜	菜品	热菜	
妈妈巧拌菜	凉菜	菜品	凉菜	
妈妈手擀面	手擀面	主食	面	手擀面
妈妈招牌粥	粥	主食	粥	
妈妈炒合菜	热菜	菜品	热菜	
妈妈炒土豆丝	热菜	菜品	热菜	
妈妈炒笨豆芽	热菜	菜品	热菜	
妈妈炒鸡蛋	热菜	菜品	热菜	
妈妈焖的米饭	白米饭	主食	饭	白米饭
妈妈的乌米饭	其他饭	主食	饭	其他饭
妈妈的核桃蛋汤	糖水/炖品	甜点	糖水/炖品	
妯娌秘制老鸭粉丝汤	其他粉	主食	粉	其他粉
妯娌老鸭汤泡饭	泡饭	主食	饭	泡饭
妯娌老鸭米粉汤	米线	主食	粉	米线
妯娌老鸭粉丝汤	汤羹	菜品	粉	其他粉
姜丝文蛤汤	汤羹	菜品	汤羹	
姜丝枸杞驱寒粥	粥	主食	粥	
姜丝蚵仔汤	汤羹	菜品	汤羹	
姜家炒带鱼	热菜	菜品	热菜	
姜师傅炖土鸡	热菜	菜品	热菜	
姜氏纯手擀面	手擀面	主食	面	手擀面
姜汁核桃炖蛋	糖水/炖品	菜品	糖水/炖品	
姜汁炒广东芥兰	热菜	菜品	热菜	
姜汁炒米饭	炒饭	主食	饭	炒饭
姜汁炒芥兰外卖	热菜	菜品	热菜	
姜汁猪肚面	汤面	主食	面	汤面
姜汁虾仁粥	粥	主食	粥	
姜汁蛋汤面	汤面	主食	面	汤面
姜汤长寿面	汤面	主食	面	汤面
姜葱冬菇滑鸡蒸饭	盖浇饭	主食	饭	盖浇饭
姜葱炒蛏子	热菜	菜品	热菜	
姜葱炒蛤蜊	热菜	菜品	热菜	
姜葱生滚鱼片粥	粥	主食	粥	
姜葱白切鸡饭	盖浇饭	主食	饭	盖浇饭
姜葱鱼腩饭	盖浇饭	主食	饭	盖浇饭
姜记大拌菜	凉菜	菜品	凉菜	
姜闷老鸭饭	盖浇饭	主食	饭	盖浇饭
姜黄咖喱花椰菜	健康餐	色拉轻食	健康餐	
姥姥家春饼合菜	热菜	菜品	热菜	
姥姥家特色青菜皮蛋瘦肉粥	粥	主食	粥	
姥姥家疙瘩汤	汤面	主食	面	汤面
姥姥葱油拌面	拌面	主食	面	拌面
姥家小炒笨豆芽	热菜	菜品	热菜	
姥家酸菜炒粉	热菜	菜品	热菜	
姬松茸乌鸡汤	汤羹	菜品	汤羹	
娃娃菜出汤	蔬菜类	火锅/串串/麻辣烫/色拉自选	配菜	蔬菜类
娃娃菜清炒	热菜	菜品	热菜	
娃娃菜炒白玉菇	热菜	菜品	热菜	
娃娃菜炒肉	热菜	菜品	热菜	
娃娃菜炒肉丝	热菜	菜品	热菜	
娃娃菜炒面筋	热菜	菜品	热菜	
娃娃菜炒鱼胶	热菜	菜品	热菜	
娃娃菜炒黑木耳肉丝	热菜	菜品	热菜	
娃娃菜炖豆腐	热菜	菜品	热菜	
嫩嫩的小南瓜炒牛肉	热菜	菜品	热菜	
嫩江手撕包菜	热菜	菜品	热菜	
嫩滑牛肉粥	粥	主食	粥	
嫩滑肉片粥	粥	主食	粥	
嫩笋瓜炒肉丝	热菜	菜品	热菜	
嫩绿的小油菜	浇头	其他	浇头	
嫩芹炒肉丝	热菜	菜品	热菜	
嫩豆腐汤份饭	其他菜品	其他	其他菜品	
嫩豆腐汤饭	泡饭	主食	饭	泡饭
嫩豆腐蔬菜汤饭	泡饭	主食	饭	泡饭
孜然炒肉小份	热菜	菜品	热菜	
孜然炒豆芽	热菜	菜品	热菜	
孜然菠菜炒豆皮	热菜	菜品	热菜	
孜然鸡丁炒菜	热菜	菜品	热菜	
宁家大拌菜	凉菜	菜品	凉菜	
宁海汤米面	米线	主食	粉	米线
宅家小炒菜花	热菜	菜品	热菜	
宅家炖老豆腐	热菜	菜品	热菜	
宅门小炖菜	热菜	菜品	热菜	
安仔丶南瓜粥	粥	主食	粥	
安康鱼尾炖豆腐	热菜	菜品	热菜	
安康鱼炖豆腐	热菜	菜品	热菜	
安溪湖头米粉汤	米线	主食	粉	米线
宜兰小炒菜花	热菜	菜品	热菜	
宜昌永和八宝粥	粥	主食	粥	
实力推荐紫菜虾皮疙瘩汤	汤羹	菜品	汤羹	
实诚八宝粥	粥	主食	粥	
客家乌米饭	焖饭	主食	饭	焖饭
客家咸鸡粥	粥	主食	粥	
宫保鸡丁十烧茄子十米饭	其他菜品	其他	其他菜品	
宫保鸡丁小份菜	热菜	菜品	热菜	
宫廷八宝粥	粥	主食	粥	
宫爆洋白菜	热菜	菜品	热菜	
家乡土鸡粥	粥	主食	粥	
家乡小炒荞头	热菜	菜品	热菜	
家乡小炒青豌豆	热菜	菜品	热菜	
家乡小青菜	热菜	菜品	热菜	
家乡海蛎粥	粥	主食	粥	
家乡炒肉片半斤	热菜	菜品	热菜	
家乡炒藕丝	热菜	菜品	热菜	
家乡炒藕尖	热菜	菜品	热菜	
家乡豆腐盖浇饭	盖浇饭	主食	饭	盖浇饭
家做土豆丝盖饭	盖浇饭	主食	饭	盖浇饭
家奶奶鸡蛋拌面	拌面	主食	面	拌面
家常凉拌菜	凉菜	菜品	凉菜	
家常噶瘩汤	汤羹	菜品	汤羹	
家常圆葱炒肉	热菜	菜品	热菜	
家常土豆炖茄子	热菜	菜品	热菜	
家常土豆炖茄子酱	热菜	菜品	热菜	
家常土豆片炒蒜苗	热菜	菜品	热菜	
家常大拌菜	凉菜	菜品	凉菜	
家常大白菜	热菜	菜品	热菜	
家常小拌菜	凉菜	菜品	凉菜	
家常小炒土豆丝	热菜	菜品	热菜	
家常小炒花菜	热菜	菜品	热菜	
家常小炒茄丁	热菜	菜品	热菜	
家常小米粥	粥	主食	粥	
家常尖椒炒豆腐皮	热菜	菜品	热菜	
家常平菇炒肉片	热菜	菜品	热菜	
家常手擀面	手擀面	主食	面	手擀面
家常拌凉菜	凉菜	菜品	凉菜	
家常旮瘩汤	汤羹	菜品	汤羹	
家常毛白菜	热菜	菜品	热菜	
家常炒包菜盖浇饭	盖浇饭	主食	饭	盖浇饭
家常炒合菜	热菜	菜品	热菜	
家常炒土豆丝	热菜	菜品	热菜	
家常炒白菜	热菜	菜品	热菜	
家常炒笨豆芽	热菜	菜品	热菜	
家常炒粉丝	热菜	菜品	热菜	
家常炒绿豆芽	热菜	菜品	热菜	
家常炒绿豆面	炒面	主食	面	炒面
家常炒腐竹	热菜	菜品	热菜	
家常炒花菜	热菜	菜品	热菜	
家常炒茄子	热菜	菜品	热菜	
家常炒莜面鱼鱼	炒面	主食	面	炒面
家常炒莴笋	热菜	菜品	热菜	
家常炒菜花	热菜	菜品	热菜	
家常炒菜花小份	热菜	菜品	热菜	
家常炒豆丝	热菜	菜品	热菜	
家常炒豆皮	热菜	菜品	热菜	
家常炒豆腐	热菜	菜品	热菜	
家常炒豆芽	热菜	菜品	热菜	
家常炒豆芽小份	热菜	菜品	热菜	
家常炒豆芽菜	热菜	菜品	热菜	
家常炒豆饼	热菜	菜品	热菜	
家常炒鸡不辣	热菜	菜品	热菜	
家常炖冻豆腐白菜	热菜	菜品	热菜	
家常炖带鱼	热菜	菜品	热菜	
家常炖菜肉少	热菜	菜品	热菜	
家常炖豆腐	热菜	菜品	热菜	
家常炖鱼头	热菜	菜品	热菜	
家常炖鳕鱼	热菜	菜品	热菜	
家常炖鸡块	热菜	菜品	热菜	
家常疙瘩汤	汤面	菜品	面	汤面
家常茄丁打卤面	盖浇面	主食	面	盖浇面
家常茄子饭	盖浇饭	主食	饭	盖浇饭
家常菜外婆菜炒蛋	热菜	菜品	热菜	
家常菜素炒丝瓜	热菜	菜品	热菜	
家常蛋花疙瘩汤	汤羹	菜品	汤羹	
家常豆腐十米饭	盖浇饭	主食	饭	盖浇饭
家常豆腐盖浇饭	盖浇饭	主食	饭	盖浇饭
家常豆腐盖米饭	盖浇饭	主食	饭	盖浇饭
家常豆腐盖饭	盖浇饭	主食	饭	盖浇饭
家常豆腐饭	盖浇饭	主食	饭	盖浇饭
家常豆芽炒粉条	热菜	菜品	热菜	
家常跨炖鱼	热菜	菜品	热菜	
家常酱炒蛋	热菜	菜品	热菜	
家常酸菜疙瘩汤	汤羹	菜品	汤羹	
家常香菇炒肉	热菜	菜品	热菜	
家常黄豆芽炒粉条	热菜	菜品	热菜	
家炒土豆丝	热菜	菜品	热菜	
家炒大豆腐	热菜	菜品	热菜	
家炒油冬菜	热菜	菜品	热菜	
家炒笨豆芽	热菜	菜品	热菜	
家炖杂瓣鱼	热菜	菜品	热菜	
家炖豆腐丁	热菜	菜品	热菜	
家炖豆腐小份	热菜	菜品	热菜	
家炖豆腐带汤的	热菜	菜品	热菜	
家炖鱼头棋盘山鲢鱼	热菜	菜品	热菜	
家炖鲜带鱼	热菜	菜品	热菜	
家炖黄鱼大份	热菜	菜品	热菜	
家烧大白菜	热菜	菜品	热菜	
家烧娃娃菜	热菜	菜品	热菜	
家烧杭白菜	热菜	菜品	热菜	
家烧油冬菜	热菜	菜品	热菜	
家烧观音菜	热菜	菜品	热菜	
家烧高山黄花菜	热菜	菜品	热菜	
家芹青椒炒肉	热菜	菜品	热菜	
家鸡炖干蘑菇	热菜	菜品	热菜	
家鸡炖榛蘑粉条	热菜	菜品	热菜	
家鸡炖蘑菇	热菜	菜品	热菜	
家鸡炖长白山榛蘑	热菜	菜品	热菜	
富贵大拌菜	凉菜	菜品	凉菜	
对虾野菌面	汤面	主食	面	汤面
小份不辣黄焖鸡米饭带一份米饭	其他饭	主食	饭	其他饭
小份乾隆白菜	凉菜	菜品	凉菜	
小份二米饭	白米饭	主食	饭	白米饭
小份农家手撕包菜	热菜	菜品	热菜	
小份凉拌大头菜	凉菜	菜品	凉菜	
小份卷饼炒杏鲍菇	热菜	菜品	热菜	
小份土豆丝小菜	凉菜	菜品	凉菜	
小份土豆丝炒芹菜	热菜	菜品	热菜	
小份土豆片炒肉	热菜	菜品	热菜	
小份地皮菜炒鸡蛋	热菜	菜品	热菜	
小份家常凉菜	凉菜	菜品	凉菜	
小份家常炖菜	热菜	菜品	热菜	
小份小炒笨豆芽	热菜	菜品	热菜	
小份小炒菜花	热菜	菜品	热菜	
小份小米香芹炒土豆丝	热菜	菜品	热菜	
小份小豆饭	焖饭	主食	饭	焖饭
小份小锅饭大拌菜	拌饭	主食	饭	拌饭
小份尖椒炒鸡蛋	热菜	菜品	热菜	
小份山药炒木耳	热菜	菜品	热菜	
小份干豆腐炒土豆粉	土豆粉	主食	粉	土豆粉
小份开心大拌菜	凉菜	菜品	凉菜	
小份手撕包菜	热菜	菜品	热菜	
小份拌青菜	凉菜	菜品	凉菜	
小份木耳炒鸡蛋	热菜	菜品	热菜	
小份木须韭菜	热菜	菜品	热菜	
小份油菜炒豆泡	热菜	菜品	热菜	
小份洋白菜炒粉	热菜	菜品	热菜	
小份海带汤	汤羹	菜品	汤羹	
小份清炒油菜	热菜	菜品	热菜	
小份滋补山珍汤	汤羹	菜品	汤羹	
小份火爆圆白菜	热菜	菜品	热菜	
小份火爆大头菜	热菜	菜品	热菜	
小份炒三丝	热菜	菜品	热菜	
小份炒合菜	热菜	菜品	热菜	
小份炒芹菜粉	热菜	菜品	热菜	
小份炒菜花	热菜	菜品	热菜	
小份炒饽饽	馒头	主食	馒头	
小份炖酸菜	热菜	菜品	热菜	
小份炖鸡一锅出	热菜	菜品	热菜	
小份炝炒圆白菜	热菜	菜品	热菜	
小份烂糊白菜	热菜	菜品	热菜	
小份牛肉清汤	汤羹	菜品	汤羹	
小份番茄炒蛋	热菜	菜品	热菜	
小份疙瘩汤	汤羹	菜品	汤羹	
小份白勺菠菜	热菜	菜品	热菜	
小份白灼西生菜	热菜	菜品	热菜	
小份白米饭	白米饭	主食	饭	白米饭
小份白菜炖豆泡	热菜	菜品	热菜	
小份白菜肋边米饭	热菜	菜品	热菜	
小份白豆腐干炒白辣椒	热菜	菜品	热菜	
小份素卷饼自选三样小菜	卷饼	主食	饼/囊/馍	卷饼
小份素炒土豆丝	热菜	菜品	热菜	
小份紫菜汤	汤羹	菜品	汤羹	
小份紫菜蛋汤	汤羹	菜品	汤羹	
小份紫菜蛋花汤	汤羹	菜品	汤羹	
小份绿豆芽炒粉	热菜	菜品	热菜	
小份羊肉白菜汤	汤羹	菜品	汤羹	
小份美极手撕包菜	热菜	菜品	热菜	
小份腐竹炒肉	热菜	菜品	热菜	
小份芹菜炒粉	其他粉	主食	粉	其他粉
小份茄子丝炒尖椒丝	热菜	菜品	热菜	
小份菌类小炒	热菜	菜品	热菜	
小份营养鸡汤	汤羹	菜品	汤羹	
小份蒜苔炒肉	热菜	菜品	热菜	
小份蒜苗炒鸡蛋	热菜	菜品	热菜	
小份蚝油生菜	热菜	菜品	热菜	
小份蛤蜊疙瘩汤	汤羹	菜品	汤羹	
小份西红柿炒鸡蛋	热菜	菜品	热菜	
小份西红柿蛋汤	汤羹	菜品	汤羹	
小份西红柿鸡蛋汤	汤羹	菜品	汤羹	
小份豆皮烧白菜	热菜	菜品	热菜	
小份豆芽菜	浇头	其他	浇头	
小份豆角丝炒肉	热菜	菜品	热菜	
小份豆角面	拌面	主食	面	拌面
小份酱炒鸡蛋	热菜	菜品	热菜	
小份酱炖豆腐	热菜	菜品	热菜	
小份醋溜木耳白菜	热菜	菜品	热菜	
小份醋熘白菜	热菜	菜品	热菜	
小份锅香手撕包菜	热菜	菜品	热菜	
小份青椒炒鸡蛋	热菜	菜品	热菜	
小份青菜自制现做纯精肉圆汤	汤羹	菜品	汤羹	
小份韭菜沫炒鸡蛋	热菜	菜品	热菜	
小份韭菜炒香干	热菜	菜品	热菜	
小份韭菜炒鸡蛋	热菜	菜品	热菜	
小份香菇油菜	热菜	菜品	热菜	
小份鱼丸汤	汤羹	菜品	汤羹	
小份鸡肉蘑菇汤	汤羹	菜品	汤羹	
小份鸡蛋木耳炒大葱	热菜	菜品	热菜	
小份鸡蛋柿子汤	汤羹	菜品	汤羹	
小份鸡蛋汤	汤羹	菜品	汤羹	
小份鸡蛋炒苦瓜	热菜	菜品	热菜	
小份黄瓜泡菜	凉菜	菜品	凉菜	
小份黄花菜汤	汤羹	菜品	汤羹	
小包谷糁子稀饭	粥	主食	粥	
小北皮蛋瘦肉粥	粥	主食	粥	
小南瓜炒肉丝	热菜	菜品	热菜	
小南瓜炒蛋	热菜	菜品	热菜	
小吃桂花红豆粥	粥	主食	粥	
小吃玉米南瓜粥	粥	主食	粥	
小喜鱼丸汤	汤羹	菜品	汤羹	
小喳子大米稀饭	粥	主食	粥	
小园油麦菜	蔬菜类	火锅/串串/麻辣烫/色拉自选	配菜	蔬菜类
小圆葱炒肉	热菜	菜品	热菜	
小小份炒小瓜	热菜	菜品	热菜	
小小份西红柿炒小白菜	热菜	菜品	热菜	
小小份黄焖鸡十土豆十青菜十米饭	其他菜品	其他	其他菜品	
小扁条切面	其他面	主食	面	其他面
小手撕包菜	蔬菜类	火锅/串串/麻辣烫/色拉自选	配菜	蔬菜类
小排冬瓜汤	汤羹	菜品	汤羹	
小排山药粥	粥	主食	粥	
小排萝卜汤	汤羹	菜品	汤羹	
小排骨冬瓜汤	汤羹	菜品	汤羹	
小排骨春菜粥	粥	主食	粥	
小时候豆腐酱汤	汤羹	菜品	汤羹	
小月烫青菜	热菜	菜品	热菜	
小木屋蔬菜拌饭	拌饭	主食	饭	拌饭
小木耳炒土鸡蛋	热菜	菜品	热菜	
小木耳炒肉	热菜	菜品	热菜	
小木耳炒蛋	热菜	菜品	热菜	
小木耳炒鸡蛋	热菜	菜品	热菜	
小杨疙瘩汤	汤羹	菜品	汤羹	
小杯小米粥	粥	主食	粥	
小枣沫糊汤	糖水/炖品	甜点	糖水/炖品	
小毛葱杭椒炒鸡蛋	热菜	菜品	热菜	
小毛葱炒笨鸡蛋	热菜	菜品	热菜	
小毛葱炒鸡蛋	热菜	菜品	热菜	
小河虾爆炒鸡毛菜	热菜	菜品	热菜	
小油包子炒青菜	热菜	菜品	热菜	
小油菜泡饭	泡饭	主食	饭	泡饭
小油菜菜丸子汤	汤羹	菜品	汤羹	
小火慢炒长豆角	热菜	菜品	热菜	
小火慢炖养胃白粥	粥	主食	粥	
小火白米粥	汤羹	菜品	汤羹	
小灶鸡肉炖粉条的粉条	热菜	菜品	热菜	
小炒三种蘑菇	热菜	菜品	热菜	
小炒仔南瓜	热菜	菜品	热菜	
小炒优县香干	热菜	菜品	热菜	
小炒兰瓜丝	热菜	菜品	热菜	
小炒养生菜	热菜	菜品	热菜	
小炒刀削藕	其他面	主食	面	其他面
小炒千叶豆腐	蔬菜类	菜品	蔬菜类	
小炒千叶豆腐小份菜	热菜	菜品	热菜	
小炒千叶豆腐盖饭	盖浇饭	主食	饭	盖浇饭
小炒千叶豆腐饭	盖浇饭	主食	饭	盖浇饭
小炒千页豆腐	热菜	菜品	热菜	
小炒千页豆腐盖饭	盖浇饭	主食	饭	盖浇饭
小炒千页豆腐饭	盖浇饭	主食	饭	盖浇饭
小炒去骨鸡腿肉	热菜	菜品	热菜	
小炒口味四季豆	热菜	菜品	热菜	
小炒四季豆	热菜	菜品	热菜	
小炒四季青	热菜	菜品	热菜	
小炒土豆丝	热菜	菜品	热菜	
小炒土豆片	热菜	菜品	热菜	
小炒奶白菜	热菜	菜品	热菜	
小炒娃娃菜	热菜	菜品	热菜	
小炒嫩笋丝	热菜	菜品	热菜	
小炒巴东豆干	热菜	菜品	热菜	
小炒干笋丝盖饭	盖浇饭	主食	饭	盖浇饭
小炒平包菜	热菜	菜品	热菜	
小炒广东菜心	热菜	菜品	热菜	
小炒扁豆丝	热菜	菜品	热菜	
小炒扁豆角	热菜	菜品	热菜	
小炒手工笋	热菜	菜品	热菜	
小炒攸县香干	热菜	菜品	热菜	
小炒有机花菜	热菜	菜品	热菜	
小炒有机菜花	热菜	菜品	热菜	
小炒木耳拆骨肉	热菜	菜品	热菜	
小炒木须肉	热菜	菜品	热菜	
小炒杂菌整份	热菜	菜品	热菜	
小炒杏鲍菇	热菜	菜品	热菜	
小炒杏鲍菇丝	热菜	菜品	热菜	
小炒柴火香干	热菜	菜品	热菜	
小炒桐庐豆干	热菜	菜品	热菜	
小炒毛尖笋	热菜	菜品	热菜	
小炒毛笋干	热菜	菜品	热菜	
小炒浏阳熏香干	热菜	菜品	热菜	
小炒浏阳笋	热菜	菜品	热菜	
小炒海带丝	热菜	菜品	热菜	
小炒淮山药	热菜	菜品	热菜	
小炒湖南丝瓜	热菜	菜品	热菜	
小炒的香干	热菜	菜品	热菜	
小炒石锅香干	热菜	菜品	热菜	
小炒砂锅菜花	热菜	菜品	热菜	
小炒笋干素肠	热菜	菜品	热菜	
小炒笨豆芽	热菜	菜品	热菜	
小炒糟菜笋	热菜	菜品	热菜	
小炒紫苏土豆片	热菜	菜品	热菜	
小炒绿豆芽	热菜	菜品	热菜	
小炒美味菌	热菜	菜品	热菜	
小炒肉土豆丝菜花豆腐米饭汤拼菜	其他菜品	其他	其他菜品	
小炒胡萝卜丝	热菜	菜品	热菜	
小炒脆皮莴笋	热菜	菜品	热菜	
小炒脆藕条	热菜	菜品	热菜	
小炒腐皮青菜	热菜	菜品	热菜	
小炒芥菜丝	热菜	菜品	热菜	
小炒花石香干	热菜	菜品	热菜	
小炒花菜小份	热菜	菜品	热菜	
小炒花菜盖饭	盖浇饭	主食	饭	盖浇饭
小炒芸豆丝	热菜	菜品	热菜	
小炒芹菜丨青翠	热菜	菜品	热菜	
小炒荷包蛋	热菜	菜品	热菜	
小炒莜县香干	热菜	菜品	热菜	
小炒莴笋皮	热菜	菜品	热菜	
小炒菜花小份	热菜	菜品	热菜	
小炒萝卜干	热菜	菜品	热菜	
小炒藏香菌	热菜	菜品	热菜	
小炒西兰花	热菜	菜品	热菜	
小炒西葫芦	热菜	菜品	热菜	
小炒豆干丝	热菜	菜品	热菜	
小炒豆腐皮	热菜	菜品	热菜	
小炒豆芽菜	热菜	菜品	热菜	
小炒豆角丝	热菜	菜品	热菜	
小炒酸菜笋丁	热菜	菜品	热菜	
小炒酸辣土豆丝	热菜	菜品	热菜	
小炒野山菌	热菜	菜品	热菜	
小炒野莴笋	热菜	菜品	热菜	
小炒金针菇	热菜	菜品	热菜	
小炒铁棍山药	热菜	菜品	热菜	
小炒香干饭	盖浇饭	主食	饭	盖浇饭
小炒高山笋	热菜	菜品	热菜	
小炒鱼豆腐小份	热菜	菜品	热菜	
小炒鲜莴笋	热菜	菜品	热菜	
小炒鸡蛋干	热菜	菜品	热菜	
小炒鹿茸菇	热菜	菜品	热菜	
小炒鹿茸菌	热菜	菜品	热菜	
小炒黄山笋尖	热菜	菜品	热菜	
小炒黄豆芽	热菜	菜品	热菜	
小炒黑木耳	热菜	菜品	热菜	
小炒龙豆丝	热菜	菜品	热菜	
小生滚鱼片砂锅粥	粥	主食	粥	
小番茄炒蛋	热菜	菜品	热菜	
小白菜串丸子汤	汤羹	菜品	汤羹	
小白菜丸子汤	汤羹	菜品	汤羹	
小白菜冻豆腐鱼丸汤	汤羹	菜品	汤羹	
小白菜剔骨汤	汤羹	菜品	汤羹	
小白菜土豆丝汤	汤羹	菜品	汤羹	
小白菜土豆炖豆腐	热菜	菜品	热菜	
小白菜排骨汤	热菜	菜品	热菜	
小白菜炒千张	热菜	菜品	热菜	
小白菜炒水晶粉	热菜	菜品	热菜	
小白菜炒滑子蘑	热菜	菜品	热菜	
小白菜炒滑菇	热菜	菜品	热菜	
小白菜炒牛肉	热菜	菜品	热菜	
小白菜炒粉条	热菜	菜品	热菜	
小白菜炒腐衣	热菜	菜品	热菜	
小白菜炒豆筋	热菜	菜品	热菜	
小白菜炒豆腐	热菜	菜品	热菜	
小白菜炒鸡蛋	热菜	菜品	热菜	
小白菜炖冻豆腐	热菜	菜品	热菜	
小白菜炖拆骨肉汤	汤羹	菜品	汤羹	
小白菜炖白丸子	热菜	菜品	热菜	
小白菜炖粉条	热菜	菜品	热菜	
小白菜炖肉丸	热菜	菜品	热菜	
小白菜炖肉丸汤	汤羹	菜品	汤羹	
小白菜炖蚬子	热菜	菜品	热菜	
小白菜炖豆腐	热菜	菜品	热菜	
小白菜炖豆腐粉丝汤	热菜	菜品	热菜	
小白菜猪肉丸子汤	汤羹	菜品	汤羹	
小白菜猪胸骨汤	汤羹	菜品	汤羹	
小白菜疙瘩汤	汤羹	菜品	汤羹	
小白菜瘦肉粥	粥	主食	粥	
小白菜秧炒千张	热菜	菜品	热菜	
小白菜肉丝汤	汤羹	菜品	汤羹	
小白菜肉圆汤	汤羹	菜品	汤羹	
小白菜花子磨土豆丝汤	汤羹	菜品	汤羹	
小白菜花鲜炖土豆	热菜	菜品	热菜	
小白菜蚬子肉炒鸡蛋	热菜	菜品	热菜	
小白菜蚬肉炒鸡蛋	热菜	菜品	热菜	
小白菜蛋汤	汤羹	菜品	汤羹	
小白菜蛋花汤	汤羹	菜品	汤羹	
小白菜豆腐木耳汤	汤羹	菜品	汤羹	
小白菜豆腐汤	热菜	菜品	热菜	
小白菜豆腐炒粉条	热菜	菜品	热菜	
小白菜豆腐炖文蛤	热菜	菜品	热菜	
小白菜酱汤	汤羹	菜品	汤羹	
小白菜香菇炒粉	米线	主食	粉	米线
小白菜鱼丸豆腐汤	汤羹	菜品	汤羹	
小白菜鸡蛋嘎达汤	汤羹	菜品	汤羹	
小白菜鸡蛋炖蚬子	热菜	菜品	热菜	
小白菜鸡蛋炖鲜贝	热菜	菜品	热菜	
小白菜鸡蛋疙瘩汤	汤羹	菜品	汤羹	
小白菜鸡蛋面疙瘩汤	汤羹	菜品	汤羹	
小白虾沙蛤米面	汤面	主食	面	汤面
小盘炒三丝	热菜	菜品	热菜	
小碗八宝粥	粥	主食	粥	
小碗刀削面	其他面	主食	面	其他面
小碗土豆炖豆角	热菜	菜品	热菜	
小碗手撕蘑菇面	盖浇面	主食	面	盖浇面
小碗杂粮饭	白米饭	主食	饭	白米饭
小碗海带丝炖豆腐	热菜	菜品	热菜	
小碗海带炖豆腐	热菜	菜品	热菜	
小碗炖丸子	热菜	菜品	热菜	
小碗牛肉炖老豆腐	热菜	菜品	热菜	
小碗白米饭	白米饭	主食	饭	白米饭
小碗素烩汤	汤羹	菜品	汤羹	
小碗紫菜蛋汤	汤羹	菜品	汤羹	
小碗紫菜蛋花汤	汤羹	菜品	汤羹	
小碗紫菜鸡蛋汤	汤羹	菜品	汤羹	
小碗红薯汤	汤羹	菜品	汤羹	
小碗老鸭粉丝汤	其他粉	主食	粉	其他粉
小碗荞面香菇肉丝饸饹面	汤面	主食	面	汤面
小碗蛤蜊芸豆鸡蛋面	汤面	主食	面	汤面
小碗西红柿炒鸡蛋	热菜	菜品	热菜	
小碗西红柿鸡蛋面	汤面	主食	面	汤面
小碴南瓜粥	粥	主食	粥	
小碴子南瓜粥	粥	主食	粥	
小磨大拌菜	凉菜	菜品	凉菜	
小秋耳炒蘑菇	热菜	菜品	热菜	
小笨鸡炖蘑菇	热菜	菜品	热菜	
小笨鸡炖蘑菇土豆	热菜	菜品	热菜	
小笨鸡炖蘑菇粉	热菜	菜品	热菜	
小笨鸡炖蘑菇粉条	热菜	菜品	热菜	
小笨鸡炖野蘑菇	热菜	菜品	热菜	
小笼包香菇小白菜	其他包子	主食	包子	其他包子
小米三药枸杞粥	粥	主食	粥	
小米健康南瓜粥	粥	主食	粥	
小米养生粥	粥	主食	粥	
小米养胃粥	粥	主食	粥	
小米南爪粥	粥	主食	粥	
小米南瓜二米粥	粥	主食	粥	
小米南瓜养胃粥	粥	主食	粥	
小米南瓜枸杞粥	粥	主食	粥	
小米南瓜燕麦粥	粥	主食	粥	
小米南瓜玉米杂粮粥	粥	主食	粥	
小米南瓜百合粥	粥	主食	粥	
小米南瓜粥	粥	主食	粥	
小米南瓜粥养胃粥	粥	主食	粥	
小米南瓜粥红枣粥	粥	主食	粥	
小米南瓜红枣枸杞粥	粥	主食	粥	
小米南瓜红枣粥	粥	主食	粥	
小米南瓜菌皇粥	粥	主食	粥	
小米地瓜粥	粥	主食	粥	
小米大枣枸杞粥	粥	主食	粥	
小米山药粥	粥	主食	粥	
小米拐磨子粥	粥	主食	粥	
小米暖胃粥	粥	主食	粥	
小米枸杞南瓜粥	粥	主食	粥	
小米枸杞粥	粥	主食	粥	
小米枸杞红枣粥	粥	主食	粥	
小米棒子粥	粥	主食	粥	
小米棒渣粥	粥	主食	粥	
小米汤炖酸菜土豆条	热菜	菜品	热菜	
小米海参粥	粥	主食	粥	
小米燕麦粥	粥	主食	粥	
小米特价粥	粥	主食	粥	
小米玉米南瓜粥	粥	主食	粥	
小米玉米渣粥	粥	主食	粥	
小米玉米粥	粥	主食	粥	
小米玉米面粥	粥	主食	粥	
小米疙瘩汤	汤羹	菜品	汤羹	
小米碴子粥	粥	主食	粥	
小米禄豆粥	粥	主食	粥	
小米粥南瓜粥	粥	主食	粥	
小米粥或者玉米粥	粥	主食	粥	
小米粥棒叉粥	粥	主食	粥	
小米粥配小菜	粥	主食	粥	
小米糊糊花生粥	粥	主食	粥	
小米糯米粥	粥	主食	粥	
小米红枣南瓜粥	粥	主食	粥	
小米红枣山药粥	粥	主食	粥	
小米红枣枸杞粥	粥	主食	粥	
小米红枣枸杞红糖粥	粥	主食	粥	
小米红枣粥	粥	主食	粥	
小米红枣红糖粥	粥	主食	粥	
小米红枣红豆粥	粥	主食	粥	
小米红糖大枣粥	粥	主食	粥	
小米红糖山药粥	粥	主食	粥	
小米红糖枣粥	粥	主食	粥	
小米红糖枸杞粥	粥	主食	粥	
小米红糖砂锅粥	粥	主食	粥	
小米红糖粥	粥	主食	粥	
小米红糖红枣养胃粥	粥	主食	粥	
小米红糖红豆粥	粥	主食	粥	
小米红薯粥	粥	主食	粥	
小米红豆稀饭	粥	主食	粥	
小米红豆粥	粥	主食	粥	
小米红豆红糖粥	粥	主食	粥	
小米绿豆百合粥	粥	主食	粥	
小米绿豆稀饭	粥	主食	粥	
小米绿豆粥	粥	主食	粥	
小米芝麻粥	粥	主食	粥	
小米花生粥	粥	主食	粥	
小米苟杞粥	粥	主食	粥	
小米苦荞养生粥	粥	主食	粥	
小米苦荞燕麦稀饭	粥	主食	粥	
小米苦荞粥	粥	主食	粥	
小米菠菜瘦肉粥	粥	主食	粥	
小米营养粥	粥	主食	粥	
小米蔬菜粥	粥	主食	粥	
小米辽参粥	粥	主食	粥	
小米金瓜枸杞粥	粥	主食	粥	
小米金瓜粥	粥	主食	粥	
小米钱钱饭	粥	主食	粥	
小米黄金粥	粥	主食	粥	
小粉皮炒鸡蛋	热菜	菜品	热菜	
小罐土鸡肚片汤	汤羹	菜品	汤羹	
小罐香菇豆腐例汤	汤羹	菜品	汤羹	
小肉丸子萝卜粉丝汤	其他粉	主食	粉	其他粉
小肉炖土豆豆角粉条小份	热菜	菜品	热菜	
小肚炖薏仁	汤羹	菜品	汤羹	
小肠枸杞叶汤	汤羹	菜品	汤羹	
小肠瘦肉粥	粥	主食	粥	
小芹菜炒肉	热菜	菜品	热菜	
小芹香干盖饭	盖浇饭	主食	饭	盖浇饭
小菜外婆菜	热菜	菜品	热菜	
小菜拼盘素菜	凉菜	菜品	凉菜	
小菜豆腐汤	汤羹	菜品	汤羹	
小葱大酱炒鸡蛋	热菜	菜品	热菜	
小葱木耳炒鸡蛋	热菜	菜品	热菜	
小葱炒土鸡蛋	热菜	菜品	热菜	
小葱炒猪血	热菜	菜品	热菜	
小葱炒笨鸡蛋	热菜	菜品	热菜	
小葱炒豆腐	热菜	菜品	热菜	
小葱炒鸡蛋	热菜	菜品	热菜	
小葱花炒鸡蛋	热菜	菜品	热菜	
小葱虾皮炒玉米饼	热菜	菜品	热菜	
小葱虾皮炒饼子	其他主食	主食	其他主食	
小葱蛋炒饭	炒饭	主食	饭	炒饭
小葱豆腐汤	汤羹	菜品	汤羹	
小葱鸡蛋炒蚬肉	热菜	菜品	热菜	
小蘑菇炒肉丁	热菜	菜品	热菜	
小蘑菇菠菜	热菜	菜品	热菜	
小虾炒西兰花	热菜	菜品	热菜	
小虾米烧芥菜	热菜	菜品	热菜	
小蛋黄娃娃菜	热菜	菜品	热菜	
小西红柿炒鸡蛋	热菜	菜品	热菜	
小豆腐汤配米饭	其他菜品	其他	其他菜品	
小豆芽炒粉丝	热菜	菜品	热菜	
小豆芽炒粉条	热菜	菜品	热菜	
小贝壳豆腐汤	汤羹	菜品	汤羹	
小镇大拌菜	凉菜	菜品	凉菜	
小青菜一份炒进去	浇头	其他	浇头	
小青菜一份炒进饭里需点主食才配送	其他小吃	小吃	其他小吃	
小青菜榨菜蛋汤	汤羹	菜品	汤羹	
小青菜炒豆饼	热菜	菜品	热菜	
小青菜炒面	炒面	主食	面	炒面
小青菜肉圆汤	汤羹	菜品	汤羹	
小青菜蛋汤	汤羹	菜品	汤羹	
小青菜香菇菜	热菜	菜品	热菜	
小馆炒干豆腐	热菜	菜品	热菜	
小鲍鱼炖盅	汤羹	菜品	汤羹	
小鲜虾砂锅粥	粥	主食	粥	
小鸡炖土豆	热菜	菜品	热菜	
小鸡炖棒蘑	热菜	菜品	热菜	
小鸡炖榛菇	热菜	菜品	热菜	
小鸡炖榛蘑	热菜	菜品	热菜	
小鸡炖榛蘑粉条	热菜	菜品	热菜	
小鸡炖滑子菇	热菜	菜品	热菜	
小鸡炖蘑菇	热菜	菜品	热菜	
小鸡炖蘑菇套餐	热菜	菜品	热菜	
小鸡炖蘑菇粉	热菜	菜品	热菜	
小鸡炖蘑菇粉小份	热菜	菜品	热菜	
小鸡炖蘑菇粉条	热菜	菜品	热菜	
小鸡炖野香菇	热菜	菜品	热菜	
小鸡炖香菇	热菜	菜品	热菜	
小鸡蘑菇炖粉条	热菜	菜品	热菜	
小麦红枣粥	粥	主食	粥	
小黄蘑娃娃菜	热菜	菜品	热菜	
小黄鱼汤面	汤面	主食	面	汤面
小黄鱼烧雪菜	热菜	菜品	热菜	
少一点点米饭	白米饭	主食	饭	白米饭
尖椒圈炒鸡蛋	热菜	菜品	热菜	
尖椒土豆丝饭	盖浇饭	主食	饭	盖浇饭
尖椒土豆片饭	盖浇饭	主食	饭	盖浇饭
尖椒娃娃菜	热菜	菜品	热菜	
尖椒干豆腐盘菜	热菜	菜品	热菜	
尖椒木耳炒鸡蛋	热菜	菜品	热菜	
尖椒沫炒鸡蛋	热菜	菜品	热菜	
尖椒油麦菜	热菜	菜品	热菜	
尖椒炒土豆丝	热菜	菜品	热菜	
尖椒炒土豆片	热菜	菜品	热菜	
尖椒炒土鸡蛋	热菜	菜品	热菜	
尖椒炒干豆腐	热菜	菜品	热菜	
尖椒炒干豆腐皮	热菜	菜品	热菜	
尖椒炒碎豆腐	热菜	菜品	热菜	
尖椒炒笋干	热菜	菜品	热菜	
尖椒炒笨鸡蛋半盘	热菜	菜品	热菜	
尖椒炒紫茄	热菜	菜品	热菜	
尖椒炒腐竹	热菜	菜品	热菜	
尖椒炒茄子	热菜	菜品	热菜	
尖椒炒虾干	热菜	菜品	热菜	
尖椒炒虾米	热菜	菜品	热菜	
尖椒炒蛋套餐	其他菜品	其他	其他菜品	
尖椒炒豆皮	热菜	菜品	热菜	
尖椒炒豆腐干	热菜	菜品	热菜	
尖椒炒豆腐皮	热菜	菜品	热菜	
尖椒炒豆腐皮盖饭	盖浇饭	主食	饭	盖浇饭
尖椒炒锦州干豆腐	热菜	菜品	热菜	
尖椒炒鸡蛋	热菜	菜品	热菜	
尖椒炒鸡蛋一份	热菜	菜品	热菜	
尖椒炒鸡蛋半分	热菜	菜品	热菜	
尖椒炒鸡蛋小份	热菜	菜品	热菜	
尖椒炒黄瓜	热菜	菜品	热菜	
尖椒白菜炒干豆腐	热菜	菜品	热菜	
尖椒笋干炒肉末	热菜	菜品	热菜	
尖椒茄子丝小份加米饭	其他菜品	其他	其他菜品	
尖椒茄子打卤面	盖浇面	主食	面	盖浇面
尖椒茄子素打卤面	盖浇面	主食	面	盖浇面
尖椒虾皮炒笋干	热菜	菜品	热菜	
尖椒豆腐皮炒鸡蛋	热菜	菜品	热菜	
尖椒豆腐皮盖饭	盖浇饭	主食	饭	盖浇饭
尖椒豆腐皮饭	盖浇饭	主食	饭	盖浇饭
尖椒豇豆炒紫茄	热菜	菜品	热菜	
尖椒韭菜炒香干	热菜	菜品	热菜	
尖椒鸡蛋打卤面	盖浇面	主食	面	盖浇面
局气素炒饼	其他主食	主食	其他主食	
层层包心菜	蔬菜类	烧烤	蔬菜类	
屋里厢菜饭	烩饭	主食	饭	烩饭
山东丸子汤	汤羹	菜品	汤羹	
山东大拌菜	凉菜	菜品	凉菜	
山东大白菜炒虾	热菜	菜品	热菜	
山东杂粮煎饼加生菜	其他主食	主食	其他主食	
山东疙瘩汤	汤羹	菜品	汤羹	
山城炒合菜	热菜	菜品	热菜	
山姆长粒香米饭	白米饭	主食	饭	白米饭
山木耳炒山药	热菜	菜品	热菜	
山楂八宝稀饭	粥	主食	粥	
山楂雪梨粥	粥	主食	粥	
山泉水小锅米饭	白米饭	主食	饭	白米饭
山泉水有机米饭	白米饭	主食	饭	白米饭
山珍老鸭粥	粥	主食	粥	
山珍豆腐汤	汤羹	菜品	汤羹	
山笋炒双菇	热菜	菜品	热菜	
山约南瓜小米粥	粥	主食	粥	
山芋粉皮汤	其他粉	主食	粉	其他粉
山芹土豆条炒肉丝	热菜	菜品	热菜	
山芹土豆炒肉丝	热菜	菜品	热菜	
山芹木耳炒山药	热菜	菜品	热菜	
山芹炒肉丝	热菜	菜品	热菜	
山药南瓜粥	粥	主食	粥	
山药咸骨粥	粥	主食	粥	
山药土鸡汤	汤羹	菜品	汤羹	
山药大麦红枣粥	粥	主食	粥	
山药小枣大麦粥	粥	主食	粥	
山药意米芡实粥	粥	主食	粥	
山药排骨木耳汤	汤羹	菜品	汤羹	
山药排骨汤	汤羹	菜品	汤羹	
山药排骨粥	粥	主食	粥	
山药排骨肉粥	粥	主食	粥	
山药木耳炒山芹	热菜	菜品	热菜	
山药木耳炒肉	热菜	菜品	热菜	
山药木耳炒肉片	热菜	菜品	热菜	
山药木耳炒虾仁	热菜	菜品	热菜	
山药木耳炒里脊	热菜	菜品	热菜	
山药枸杞地瓜粥	粥	主食	粥	
山药枸杞小米粥	粥	主食	粥	
山药枸杞粥	粥	主食	粥	
山药桂圆红枣粥	粥	主食	粥	
山药活虾粥	粥	主食	粥	
山药滑鸡粥	粥	主食	粥	
山药炒扁豆	热菜	菜品	热菜	
山药炒木耳	热菜	菜品	热菜	
山药炒牛柳	热菜	菜品	热菜	
山药炒牛肉	热菜	菜品	热菜	
山药炒番茄	热菜	菜品	热菜	
山药炒秋耳	热菜	菜品	热菜	
山药炒秋葵	热菜	菜品	热菜	
山药炒窝笋	热菜	菜品	热菜	
山药炒肉片	热菜	菜品	热菜	
山药炒芥兰	热菜	菜品	热菜	
山药炒芦笋	热菜	菜品	热菜	
山药炒苦瓜	热菜	菜品	热菜	
山药炒莴笋	热菜	菜品	热菜	
山药炒莴笋片	热菜	菜品	热菜	
山药炒莴苣	热菜	菜品	热菜	
山药炒虾仁	热菜	菜品	热菜	
山药炒虾球	热菜	菜品	热菜	
山药炒蜜豆	热菜	菜品	热菜	
山药炒西兰花	热菜	菜品	热菜	
山药炒青笋半份	热菜	菜品	热菜	
山药炒鸡丝	热菜	菜品	热菜	
山药炒黑木耳	热菜	菜品	热菜	
山药炖南瓜	热菜	菜品	热菜	
山药炖排骨	热菜	菜品	热菜	
山药炖排骨煲	汤羹	菜品	汤羹	
山药炖牛肉	热菜	菜品	热菜	
山药炖猪肚	热菜	菜品	热菜	
山药炖驴肉	热菜	菜品	热菜	
山药煨乌鸡汤	汤羹	菜品	汤羹	
山药煨腔骨汤	汤羹	菜品	汤羹	
山药燕麦粥	粥	主食	粥	
山药牛肉粥	粥	主食	粥	
山药猪肝粥	粥	主食	粥	
山药玉米排骨汤	汤羹	菜品	汤羹	
山药玉米炒虾仁	热菜	菜品	热菜	
山药玉米粥	粥	主食	粥	
山药玉米青菜粥	粥	主食	粥	
山药瘦肉砂锅粥	粥	主食	粥	
山药瘦肉粥	粥	主食	粥	
山药百合枸杞粥	粥	主食	粥	
山药百合粥	粥	主食	粥	
山药百合莲子粥	粥	主食	粥	
山药砂锅粥	粥	主食	粥	
山药紫薯粥	粥	主食	粥	
山药红枣枸杞粥	粥	主食	粥	
山药红枣粥	粥	主食	粥	
山药红豆粥	粥	主食	粥	
山药羊肉粥	粥	主食	粥	
山药老鸭汤	汤羹	菜品	汤羹	
山药肉丝粥	粥	主食	粥	
山药肉片饭	盖浇饭	主食	饭	盖浇饭
山药肉碎粥	粥	主食	粥	
山药肚片汤	汤羹	菜品	汤羹	
山药芡实鸽子汤	汤羹	菜品	汤羹	
山药芥兰炒木耳	热菜	菜品	热菜	
山药茯苓汤	汤羹	菜品	汤羹	
山药荷兰豆炒木耳	热菜	菜品	热菜	
山药莲藕排骨汤	汤羹	菜品	汤羹	
山药薏仁粥	粥	主食	粥	
山药薏仁粥送咸菜	其他菜品	其他	其他菜品	
山药薏米红枣粥	粥	主食	粥	
山药蜜豆炒虾仁	热菜	菜品	热菜	
山药西芹炒木耳	热菜	菜品	热菜	
山药雪梨粥	粥	主食	粥	
山药青瓜炒木耳	热菜	菜品	热菜	
山药青笋炒虾仁	热菜	菜品	热菜	
山药青菜玉米粥	粥	主食	粥	
山药青菜瘦肉粥	粥	主食	粥	
山药青菜粥	粥	主食	粥	
山药香菇粥	粥	主食	粥	
山药香菇鸡丝粥	粥	主食	粥	
山药鸡丝粥	粥	主食	粥	
山药鸡肉粥	粥	主食	粥	
山药鸽子汤	汤羹	菜品	汤羹	
山药鹆子粥	粥	主食	粥	
山药麦仁粥	粥	主食	粥	
山药黑米粥	粥	主食	粥	
山药黑鱼汤	汤羹	菜品	汤羹	
山菌炖猪肚	汤羹	菜品	汤羹	
山菌鸡丝粥	粥	主食	粥	
山蘑炒小白菜	热菜	菜品	热菜	
山西家常面	汤面	主食	面	汤面
山西小米粥	粥	主食	粥	
山里人农家面	汤面	主食	面	汤面
山里人炒手工面	炒面	主食	面	炒面
山里人炒米面	炒面	主食	面	炒面
山里人青菜肉丝面	汤面	主食	面	汤面
山里人黄鱼鲞豆腐皮面	汤面	主食	面	汤面
山野荠荠菜	热菜	菜品	热菜	
山鸡蛋炒大葱	热菜	菜品	热菜	
岐山臊子菠菜面	拌面	主食	面	拌面
岚县炒莜面	炒面	主食	面	炒面
岛上番茄炒蛋	热菜	菜品	热菜	
岛上黄瓜木耳炒火腿	热菜	菜品	热菜	
岭南豆豉娃娃菜	热菜	菜品	热菜	
崂山菇炒肉	热菜	菜品	热菜	
崂山菇炒腐竹	热菜	菜品	热菜	
崂山蘑菇炒肉	热菜	菜品	热菜	
崇明小菠菜	热菜	菜品	热菜	
嵊州炒榨面	米线	主食	面	米线
川味手撕包菜	热菜	菜品	热菜	
川贝海底椰响锣炖瘦肉汤	汤羹	菜品	汤羹	
川贝雪梨粥	粥	主食	粥	
巧媳妇拌莜面	其他面	主食	面	其他面
巧媳妇炒松菇	热菜	菜品	热菜	
巧嫂大拌菜	凉菜	菜品	凉菜	
巧手大拌菜	凉菜	菜品	凉菜	
巧手拌合菜	凉菜	菜品	凉菜	
巧手撕包菜	热菜	菜品	热菜	
巧拌山野菜	凉菜	菜品	凉菜	
巧拌盆盆菜	凉菜	菜品	凉菜	
巴东干子炒芹菜	热菜	菜品	热菜	
巴沙鱼片粥	粥	主食	粥	
巴盟烂腌菜	浇头	其他	浇头	
帝王娃娃菜	热菜	菜品	热菜	
带鱼扒白菜	热菜	菜品	热菜	
干巴丝青菜炒饭	炒饭	主食	饭	炒饭
干拌西红柿鸡蛋面	拌面	主食	面	拌面
干拌青菜小面	拌面	主食	面	拌面
干挑番茄鸡蛋面	炒饭	主食	饭	炒饭
干果腊八粥	粥	主食	粥	
干炒包心菜	热菜	菜品	热菜	
干炒四季豆	热菜	菜品	热菜	
干炒大头菜	热菜	菜品	热菜	
干炒小蚕豆	热菜	菜品	热菜	
干炒有机花菜	热菜	菜品	热菜	
干炒杏鲍菇半份	热菜	菜品	热菜	
干炒白豆腐	热菜	菜品	热菜	
干炒铁棍山药	热菜	菜品	热菜	
干煲娃娃菜	热菜	菜品	热菜	
干煸包心菜	热菜	菜品	热菜	
干煸卷心菜	热菜	菜品	热菜	
干煸大头菜	热菜	菜品	热菜	
干煸娃娃菜	热菜	菜品	热菜	
干煸小青菜	热菜	菜品	热菜	
干煸手撕包心菜	热菜	菜品	热菜	
干煸手撕包菜	热菜	菜品	热菜	
干煸手撕菜	热菜	菜品	热菜	
干煸豆角小份菜	热菜	菜品	热菜	
干煸豆角炒菜	热菜	菜品	热菜	
干笋炖小春鱼	热菜	菜品	热菜	
干莴笋炒肉	热菜	菜品	热菜	
干菜炒刀豆	热菜	菜品	热菜	
干菜炒四季豆	热菜	菜品	热菜	
干菜蒲子番茄汤	汤羹	菜品	汤羹	
干豆腐丝炒绿豆芽	热菜	菜品	热菜	
干豆腐卷油麦菜	蔬菜类	烧烤	蔬菜类	
干豆腐卷菜	蔬菜类	烧烤	蔬菜类	
干豆腐卷葱香菜	蔬菜类	烧烤	蔬菜类	
干豆腐卷青菜	蔬菜类	烧烤	蔬菜类	
干豆腐卷香菜	蔬菜类	烧烤	配菜	蔬菜类
干豆腐炒土豆片	热菜	菜品	热菜	
干豆腐炒尖椒	热菜	菜品	热菜	
干豆腐炒木耳半盘	热菜	菜品	热菜	
干豆腐炒白菜	热菜	菜品	热菜	
干豆腐炒豆芽韭菜	热菜	菜品	热菜	
干豆腐炒青椒	热菜	菜品	热菜	
干豆腐炒韭菜	热菜	菜品	热菜	
干豆腐炖土豆片	热菜	菜品	热菜	
干豆腐爱白菜	热菜	菜品	热菜	
干豆角炒肉	热菜	菜品	热菜	
干豆角炒肉丝	热菜	菜品	热菜	
干豆角炖鸡蛋小份	热菜	菜品	热菜	
干贝七彩汤	汤羹	菜品	汤羹	
干贝冬瓜汤	汤羹	菜品	汤羹	
干贝排骨粥	粥	主食	粥	
干贝明虾粥	粥	主食	粥	
干贝海鲜粥	粥	主食	粥	
干贝玉米瘦肉粥	粥	主食	粥	
干贝玉米鲜虾粥	粥	主食	粥	
干贝瘦肉粥	粥	主食	粥	
干贝皮蛋粥	粥	主食	粥	
干贝砂锅粥	粥	主食	粥	
干贝肉丝粥	粥	主食	粥	
干贝肉碎蚝仔粥	粥	主食	粥	
干贝萝卜丝汤	汤羹	菜品	汤羹	
干贝萝卜汤	汤羹	菜品	汤羹	
干贝虾仁粥	粥	主食	粥	
干贝虾仁青菜粥	粥	主食	粥	
干贝青菜粥	粥	主食	粥	
干贝香菇粥	粥	主食	粥	
干贝鱼片砂锅粥	粥	主食	粥	
干贝鱼片粥	粥	主食	粥	
干贝鱿鱼粥	粥	主食	粥	
干贝鲍鱼粥	粥	主食	粥	
干贝鲜虾砂锅粥	粥	主食	粥	
干贝鲜虾粥	粥	主食	粥	
干贝鲜鱼片粥	粥	主食	粥	
干贝鸡丝粥	粥	主食	粥	
干锅什锦菜	热菜	菜品	热菜	
干锅农家花菜	热菜	菜品	热菜	
干锅加菜油麦菜	蔬菜类	火锅/串串/麻辣烫/色拉自选	配菜	蔬菜类
干锅包心菜	热菜	菜品	热菜	
干锅包心菜丨小干炒	热菜	菜品	热菜	
干锅卷心菜	热菜	菜品	热菜	
干锅大头菜	热菜	菜品	热菜	
干锅娃娃菜	热菜	菜品	热菜	
干锅小藤花菜	热菜	菜品	热菜	
干锅平包菜	热菜	菜品	热菜	
干锅手撕包心菜	热菜	菜品	热菜	
干锅手撕包菜	热菜	菜品	热菜	
干锅手撕卷心菜	热菜	菜品	热菜	
干锅手撕牛心包菜	热菜	菜品	热菜	
干锅手撕苞菜	热菜	菜品	热菜	
干锅散花菜	热菜	菜品	热菜	
干锅有机花菜	热菜	菜品	热菜	
干锅有机菜	热菜	菜品	热菜	
干锅炒菜花	热菜	菜品	热菜	
干锅烧花菜	热菜	菜品	热菜	
干锅焗花菜	热菜	菜品	热菜	
干锅爽口花菜	热菜	菜品	热菜	
干锅番茄烧花菜	热菜	菜品	热菜	
干锅空心菜	热菜	菜品	热菜	
干锅粉丝包菜	热菜	菜品	热菜	
干锅绿梗花菜	热菜	菜品	热菜	
干锅茶树菇米饭	热菜	菜品	热菜	
干锅菜花和米饭	其他菜品	其他	其他菜品	
干锅菜花炒菜	热菜	菜品	热菜	
干锅豆芽菜	热菜	菜品	热菜	
干锅酱炒有机花菜	热菜	菜品	热菜	
干锅香菇花菜	热菜	菜品	热菜	
干锅黄子菜	热菜	菜品	热菜	
平湖炒三鲜	热菜	菜品	热菜	
平茹炒鸡蛋	热菜	菜品	热菜	
平菇炒大蒜肉丝	热菜	菜品	热菜	
平菇炒肉丝	热菜	菜品	热菜	
平菇炒肉片	热菜	菜品	热菜	
平菇炒鸡蛋	热菜	菜品	热菜	
平菇炖豆腐	热菜	菜品	热菜	
平菇肉圆汤	汤羹	菜品	汤羹	
平菇肉片汤	汤羹	菜品	汤羹	
幸福满满红豆粥	粥	主食	粥	
广东丝瓜炒木耳	热菜	菜品	热菜	
广东唐生菜	热菜	菜品	热菜	
广东经典罗马生菜	浇头	其他	浇头	
广东芥蓝炒牛肉	热菜	菜品	热菜	
广东芥蓝菜	凉菜	菜品	凉菜	
广东菜心粥	粥	主食	粥	
广东西洋菜	蔬菜类	火锅/串串/麻辣烫/色拉自选	配菜	蔬菜类
广州艇仔粥	粥	主食	粥	
广式瓦罐乌鸡汤	汤羹	菜品	汤羹	
广式生炒花菜	热菜	菜品	热菜	
广式皮蛋瘦肉粥	粥	主食	粥	
广式老鸡肉丁煲汤	汤羹	菜品	汤羹	
广式荔湾艇仔粥	粥	主食	粥	
广式菜心炒牛肉	热菜	菜品	热菜	
广式蒜蓉娃娃菜	热菜	菜品	热菜	
广式虫草花炖乌鸡	汤羹	菜品	汤羹	
广式鱼丸汤	汤羹	菜品	汤羹	
庐山小云耳炒肉	热菜	菜品	热菜	
店长推荐丨皮蛋瘦肉粥	粥	主食	粥	
廋肉青菜汤	汤羹	菜品	汤羹	
廋肉黑白菜	热菜	菜品	热菜	
延吉大碗荞麦冷面	凉面	主食	面	凉面
延边珍珠米饭	白米饭	主食	饭	白米饭
开心大拌菜	凉菜	菜品	凉菜	
开心小米粥	粥	主食	粥	
开春香椿芽炒鸡蛋	热菜	菜品	热菜	
开洋冬瓜汤	汤羹	菜品	汤羹	
开胃什锦菜	凉菜	菜品	凉菜	
开胃八宝粥	粥	主食	粥	
开胃小米粥	粥	主食	粥	
开胃小芹菜	热菜	菜品	热菜	
开胃小鱼汤	汤羹	菜品	汤羹	
开胃杂粮小米粥	粥	主食	粥	
开胃白米粥	粥	主食	粥	
开胃酸包菜	凉菜	菜品	凉菜	
开胃酸笋瘦肉豆腐汤	汤羹	菜品	汤羹	
开胃酸菜汤	汤羹	菜品	汤羹	
开胃酸辣汤	汤羹	菜品	汤羹	
张记特色小米粥	粥	主食	粥	
强身健体的山药炒木耳	热菜	菜品	热菜	
归园参鸡汤	汤羹	菜品	汤羹	
当归乌鸡汤	汤羹	菜品	汤羹	
当归牛肉汤	汤羹	菜品	汤羹	
当归红枣乌鸡汤	汤羹	菜品	汤羹	
当归莲子老鸭汤	汤羹	菜品	汤羹	
当归黄芪党参乌鸡汤	汤羹	菜品	汤羹	
当日鲜娃娃菜	蔬菜类	火锅/串串/麻辣烫/色拉自选	配菜	蔬菜类
彩桥疙瘩汤	汤羹	菜品	汤羹	
彭记老鸭汤	汤羹	菜品	汤羹	
很好吃的大白菜	热菜	菜品	热菜	
很正常的白米饭	白米饭	主食	饭	白米饭
御品八宝粥	粥	主食	粥	
御膳金汤海参捞饭	捞饭	主食	饭	捞饭
御贡香米饭	白米饭	主食	饭	白米饭
御面堂素面	汤面	主食	面	汤面
微粮南瓜粥	粥	主食	粥	
微粮燕麦粥	粥	主食	粥	
微粮荷叶粥	粥	主食	粥	
微辣老鸭粉丝汤	其他粉	主食	粉	其他粉
德仁大拌菜	凉菜	菜品	凉菜	
德利炒三丝	热菜	菜品	热菜	
德盛特色紫米红豆粥	粥	主食	粥	
徽州笋干面	盖浇面	主食	面	盖浇面
心意南瓜粥	粥	主食	粥	
心甘情愿黄韭肉丝小炒	热菜	菜品	热菜	
必点三鲜疙瘩汤	汤羹	菜品	汤羹	
必点商品米饭	白米饭	主食	饭	白米饭
忒色菠菜面	拌面	主食	面	拌面
忘不了的花菜	蔬菜类	烧烤	蔬菜类	
忘不掉的豆腐汤	汤羹	菜品	汤羹	
快餐粉皮芹菜	热菜	菜品	热菜	
快餐西红柿炒鸡蛋	热菜	菜品	热菜	
怡神黑米粥	粥	主食	粥	
急火蒸西生菜	热菜	菜品	热菜	
总厨沙拉大拌菜	凉菜	菜品	凉菜	
情深深雨蒙蒙丝瓜蛋汤	汤羹	菜品	汤羹	
意大利生菜	浇头	其他	浇头	
意大利番茄意面	意大利面	主食	面	意大利面
意大利蘑菇汤	汤羹	菜品	汤羹	
意式番茄鸡肉面	意大利面	主食	面	意大利面
意式香浓菜汤	汤羹	菜品	汤羹	
慢火炖芋头	热菜	菜品	热菜	
慢熬八宝粥	粥	主食	粥	
慢熬多肉牛肉汤	汤羹	菜品	汤羹	
慢熬牛肉汤	汤羹	菜品	汤羹	
慢熬白米粥	粥	主食	粥	
慢熬红豆粥	粥	主食	粥	
戈雅鱼炖豆腐汤	汤羹	菜品	汤羹	
成都煎蛋汤	汤羹	菜品	汤羹	
我家姜汤面	汤面	主食	面	汤面
我要一份米饭	白米饭	主食	饭	白米饭
我要加一份大白菜	热菜	菜品	热菜	
我需要点米饭	白米饭	主食	饭	白米饭
扁豆土伏汤	汤羹	菜品	汤羹	
扁豆炒肉丝	热菜	菜品	热菜	
扁豆牛肉丝炒土豆丝双拼套餐	其他菜品	其他	其他菜品	
扁豆薏米炖鸡脚	汤羹	菜品	汤羹	
扁豆角干炒肉	热菜	菜品	热菜	
扁食瘦肉汤	馄饨	主食	馄饨	
扇贝柱炒韭菜鸡蛋	热菜	菜品	热菜	
扇贝柱炒鸡蛋	热菜	菜品	热菜	
扇贝肉小白菜	热菜	菜品	热菜	
扇贝肉拌菠菜	凉菜	菜品	凉菜	
扇贝肉炒开春小芽豆	热菜	菜品	热菜	
扇贝肉炒韭菜鸡蛋	热菜	菜品	热菜	
扇贝肉炒鸡蛋	热菜	菜品	热菜	
扇贝肉炖小白菜粉	热菜	菜品	热菜	
手工丸子汤	汤羹	菜品	汤羹	
手工刀削面	其他面	主食	面	其他面
手工双色丸子青瓜汤	汤羹	菜品	汤羹	
手工四合一菠菜面	拌面	主食	面	拌面
手工拉条面	其他面	主食	面	其他面
手工水猪肉白菜	饺子	主食	饺子	
手工水猪肉芹菜	饺子	主食	饺子	
手工清炒土豆丝	热菜	菜品	热菜	
手工炒面片小碗	炒面	主食	面	炒面
手工熬制小米粥	粥	主食	粥	
手工疙瘩汤	汤羹	菜品	汤羹	
手工素凉拌面	拌面	主食	面	拌面
手工绿豆面	汤面	主食	面	汤面
手工臊子面	汤面	主食	面	汤面
手工蒸猪肉白菜	饺子	主食	饺子	
手工蒸猪肉芹菜	饺子	主食	饺子	
手工蛋花珍珠汤	汤羹	菜品	汤羹	
手工豆芽菜	热菜	菜品	热菜	
手工青菜面	汤面	主食	面	汤面
手工面结汤	汤羹	菜品	汤羹	
手工鲜烩面	其他菜品	其他	其他菜品	
手工鸡蛋面	其他菜品	其他	其他菜品	
手打生汆丸子汤	汤羹	菜品	汤羹	
手打虾滑粥	粥	主食	粥	
手打鱼丸汤	汤羹	菜品	汤羹	
手打鲅鱼丸子汤	汤羹	菜品	汤羹	
手把蘸酱菜	凉菜	菜品	凉菜	
手抓饼鸡蛋海带丝生菜	手抓饼	主食	饼/囊/馍	手抓饼
手拉蔬菜面	汤面	主食	面	汤面
手捏菜炒口蘑	热菜	菜品	热菜	
手捏菜炒毛豆	热菜	菜品	热菜	
手捏菜炒蘑菇	热菜	菜品	热菜	
手捏菜炒鲜菇	热菜	菜品	热菜	
手捏菜蘑菇炒肉片	热菜	菜品	热菜	
手捏鸡毛菜	蔬菜类	火锅/串串/麻辣烫/色拉自选	配菜	蔬菜类
手撕什锦菜	热菜	菜品	热菜	
手撕兰州包菜	热菜	菜品	热菜	
手撕包包菜	热菜	菜品	热菜	
手撕包心菜	热菜	菜品	热菜	
手撕包菜小炒	热菜	菜品	热菜	
手撕包菜炒豆皮	热菜	菜品	热菜	
手撕包菜盖浇饭	盖浇饭	主食	饭	盖浇饭
手撕包菜盖饭	盖浇饭	主食	饭	盖浇饭
手撕卷心菜	热菜	菜品	热菜	
手撕圆包菜	热菜	菜品	热菜	
手撕圆白菜	热菜	菜品	热菜	
手撕圆白菜盖饭	盖浇饭	主食	饭	盖浇饭
手撕大包菜	热菜	菜品	热菜	
手撕大头菜菜	热菜	菜品	热菜	
手撕大拌菜	热菜	菜品	热菜	
手撕平包菜	热菜	菜品	热菜	
手撕洋白菜	热菜	菜品	热菜	
手撕牛心包菜	热菜	菜品	热菜	
手撕牛心菜	热菜	菜品	热菜	
手撕莲花菜	热菜	菜品	热菜	
手撕蘑菇原汤面	汤面	主食	面	汤面
手撕酸辣包菜	热菜	菜品	热菜	
手撕鸡裙带菜	凉菜	菜品	凉菜	
手擀打卤面	手擀面	主食	面	手擀面
手擀炝锅面	手擀面	主食	面	手擀面
手擀番茄面汤	手擀面	主食	面	手擀面
手擀精制臊子面	手擀面	主食	面	手擀面
手擀糊涂面	手擀面	主食	面	手擀面
手擀绿豆炝锅面	手擀面	主食	面	手擀面
手擀肉丝面	手擀面	主食	面	手擀面
手擀面加玉米面	手擀面	主食	面	手擀面
手擀面鸡蛋面	手擀面	主食	面	手擀面
手擀鸡蛋面	手擀面	主食	面	手擀面
手斯圆白菜	热菜	菜品	热菜	
托古小米粥	粥	主食	粥	
托谷小米粥	粥	主食	粥	
扬州炒饭小份	炒饭	主食	饭	炒饭
扬州蔬菜炒饭	炒饭	主食	饭	炒饭
批把炖雪梨	糖水/炖品	甜点	糖水/炖品	
抗衰调压黑米粥	粥	主食	粥	
抗饿的米饭	白米饭	主食	饭	白米饭
折二根拌酸菜	凉菜	菜品	凉菜	
折扣油麦菜	浇头	其他	浇头	
折骨肉炖白菜	热菜	菜品	热菜	
抢炒红苕尖	热菜	菜品	热菜	
护心肉豆角双拼饭	盖浇饭	主食	饭	盖浇饭
拆骨肉大白菜炖豆腐粉	热菜	菜品	热菜	
拆骨肉炒本豆芽	热菜	菜品	热菜	
拆骨肉炒白菜干豆腐	热菜	菜品	热菜	
拆骨肉炖大白菜粉	热菜	菜品	热菜	
拆骨肉炖白菜	热菜	菜品	热菜	
拆骨肉酸菜炖冻豆腐	热菜	菜品	热菜	
拉皮炒西芹	热菜	菜品	热菜	
拌三丁小菜	凉菜	菜品	凉菜	
拌小份生菜	凉菜	菜品	凉菜	
拌果仁菠菜	凉菜	菜品	凉菜	
拌荞麦冷面	凉面	主食	面	凉面
拌西兰花菜	凉菜	菜品	凉菜	
拍蒜木耳炒菜心	热菜	菜品	热菜	
拍蒜香炒西兰花	热菜	菜品	热菜	
招牌中华八宝粥	粥	主食	粥	
招牌丸子汤	汤羹	菜品	汤羹	
招牌乌鸡汤	汤羹	菜品	汤羹	
招牌八宝粥	粥	主食	粥	
招牌冰糖八宝粥	粥	主食	粥	
招牌南瓜粥	粥	主食	粥	
招牌四红粥	粥	主食	粥	
招牌土鸡汤	汤羹	菜品	汤羹	
招牌大拌菜	凉菜	菜品	凉菜	
招牌大白菜	热菜	菜品	热菜	
招牌妯娌老鸭粉丝汤	其他粉	主食	粉	其他粉
招牌姜汤面	汤面	主食	面	汤面
招牌小炒云南黑土鸡	热菜	菜品	热菜	
招牌小炒茄	热菜	菜品	热菜	
招牌小米粥	粥	主食	粥	
招牌手擀面	手擀面	主食	面	手擀面
招牌打卤面	盖浇面	主食	面	盖浇面
招牌明目枸杞叶汤	汤羹	菜品	汤羹	
招牌明目枸杞汤	汤羹	菜品	汤羹	
招牌枸杞叶猪杂汤	汤羹	菜品	汤羹	
招牌洋葱炒土豆	热菜	菜品	热菜	
招牌海鲜粥	粥	主食	粥	
招牌清炒藕片	热菜	菜品	热菜	
招牌潮汕砂锅鲍鱼海参鱼片粥	粥	主食	粥	
招牌炒三鲜	热菜	菜品	热菜	
招牌炒粉丝	其他粉	主食	粉	其他粉
招牌炖牛肉	热菜	菜品	热菜	
招牌热汤面	汤面	主食	面	汤面
招牌煮鸡蛋韭菜	饺子	主食	饺子	
招牌特色豆腐汤饭	泡饭	主食	饭	泡饭
招牌状元及第粥	粥	主食	粥	
招牌生滚猪肉粥	粥	主食	粥	
招牌番茄挂面汤	汤面	主食	面	汤面
招牌番茄煎蛋面	汤面	主食	面	汤面
招牌番茄牛肉面	汤面	主食	面	汤面
招牌白菜炖豆腐	热菜	菜品	热菜	
招牌皮蛋瘦肉粥	粥	主食	粥	
招牌精品老鸭粉丝汤	其他粉	主食	粉	其他粉
招牌素炒面	炒面	主食	面	炒面
招牌紫米饭	盖浇饭	主食	饭	盖浇饭
招牌红枣八宝粥	粥	主食	粥	
招牌绿豆粥	粥	主食	粥	
招牌罗宋汤	汤羹	菜品	汤羹	
招牌美味海鲜粥	粥	主食	粥	
招牌老北京打卤面	盖浇面	主食	面	盖浇面
招牌老汤面	汤面	主食	面	汤面
招牌老鸭汤	汤羹	菜品	粉	其他粉
招牌老鸭粉丝汤	其他粉	主食	粉	其他粉
招牌自制手打鱼丸汤	汤羹	菜品	汤羹	
招牌花胶乌鸡炖汤	汤羹	菜品	汤羹	
招牌芸豆饭	其他饭	主食	饭	其他饭
招牌芹菜鸡肉炒米粉	米线	主食	粉	米线
招牌茄子打卤面	盖浇面	主食	面	盖浇面
招牌茄子盖浇饭	盖浇饭	主食	饭	盖浇饭
招牌茄子盖饭	盖浇饭	主食	饭	盖浇饭
招牌茄子饭	盖浇饭	主食	饭	盖浇饭
招牌营养五红粥	粥	主食	粥	
招牌营养沙汤	汤羹	菜品	汤羹	
招牌蔬菜瘦肉粥	粥	主食	粥	
招牌虾蟹粥	粥	主食	粥	
招牌蛋花汤	汤羹	菜品	汤羹	
招牌西红柿鸡蛋打卤面	盖浇面	主食	面	盖浇面
招牌豆腐汤	汤羹	菜品	汤羹	
招牌酸萝卜老鸭汤	汤羹	菜品	汤羹	
招牌酸辣白菜	热菜	菜品	热菜	
招牌重庆清汤小面	汤面	主食	面	汤面
招牌金黄南瓜粥	粥	主食	粥	
招牌风味大拌菜	凉菜	菜品	凉菜	
招牌香菇面	其他菜品	其他	其他菜品	
招牌鱼汤娃娃菜	热菜	菜品	热菜	
招牌鱼汤面	汤面	主食	面	汤面
招牌鲜虾粥	粥	主食	粥	
招牌鸡丝荞面	拌面	主食	面	拌面
招牌鸡胸肉荞麦面	凉面	主食	面	凉面
招牌鸡蛋面	汤面	主食	面	汤面
招牌黄焖鸡千张小白菜十米饭	其他菜品	其他	其他菜品	
招牌黄焖鸡小白菜土豆金针菇十米饭	其他菜品	其他	其他菜品	
拼盘凉拌菜	凉菜	菜品	凉菜	
拼盘小凉菜	凉菜	菜品	凉菜	
拾全八宝粥	粥	主食	粥	
拾全腊八粥	粥	主食	粥	
拿手大拌菜	凉菜	菜品	凉菜	
拿手菜煎炖黄花鱼	热菜	菜品	热菜	
捞汁凉拌菜	凉菜	菜品	凉菜	
捞汁圆白菜	凉菜	菜品	凉菜	
捞汁大拌菜	凉菜	菜品	凉菜	
捞汁西生菜	凉菜	菜品	凉菜	
排骨东瓜汤	汤羹	菜品	汤羹	
排骨冬瓜汤	汤羹	菜品	汤羹	
排骨冬瓜玉米汤	汤羹	菜品	汤羹	
排骨加虾粥	粥	主食	粥	
排骨土豆黄豆芽米饭	其他菜品	其他	其他菜品	
排骨小白菜	热菜	菜品	热菜	
排骨小白菜炖豆腐	热菜	菜品	热菜	
排骨山药汤	汤羹	菜品	汤羹	
排骨山药粥	粥	主食	粥	
排骨干贝粥	粥	主食	粥	
排骨明虾粥	粥	主食	粥	
排骨汤炖素菜含米饭	其他菜品	其他	其他菜品	
排骨海带汤	汤羹	菜品	汤羹	
排骨海带瓦罐汤	汤羹	菜品	汤羹	
排骨炖东北豆角	热菜	菜品	热菜	
排骨炖冬瓜	热菜	菜品	热菜	
排骨炖冻豆腐粉条酸菜	热菜	菜品	热菜	
排骨炖土豆	热菜	菜品	热菜	
排骨炖土豆豆腐双人份	热菜	菜品	热菜	
排骨炖土豆豆角	热菜	菜品	热菜	
排骨炖小白菜	热菜	菜品	热菜	
排骨炖山药	热菜	菜品	热菜	
排骨炖玉米汤	汤羹	菜品	汤羹	
排骨炖藕汤	汤羹	菜品	汤羹	
排骨炖豆腐	热菜	菜品	热菜	
排骨炖豆腐白菜	热菜	菜品	热菜	
排骨炖豆角	热菜	菜品	热菜	
排骨炖豆角土豆	热菜	菜品	热菜	
排骨炖豆角粉条	热菜	菜品	热菜	
排骨玉米汤	汤羹	菜品	汤羹	
排骨玉米粥	粥	主食	粥	
排骨瘦肉粥	粥	主食	粥	
排骨白萝卜汤	汤羹	菜品	汤羹	
排骨芋头汤	汤羹	菜品	汤羹	
排骨芋头粥	粥	主食	粥	
排骨花生粥	粥	主食	粥	
排骨苦瓜汤	汤羹	菜品	汤羹	
排骨莲藕汤	汤羹	菜品	汤羹	
排骨莲藕汤泡饭	泡饭	主食	饭	泡饭
排骨萝卜汤	汤羹	菜品	汤羹	
排骨虫草花炖冬瓜	热菜	菜品	热菜	
排骨豆腐小白菜	热菜	菜品	热菜	
排骨连藕汤	汤羹	菜品	汤羹	
排骨霍伏洋参须汤	汤羹	菜品	汤羹	
排骨青菜粥	粥	主食	粥	
探花八宝粥	粥	主食	粥	
推荐皮蛋瘦肉粥	粥	主食	粥	
搭配最多的圆生菜	浇头	其他	浇头	
摊摊面清汤	汤面	主食	面	汤面
擂辣椒炒花菜	热菜	菜品	热菜	
擂辣椒炒菜花	热菜	菜品	热菜	
攸县小炒香干	热菜	菜品	热菜	
攸县香干饭	木桶饭	主食	饭	木桶饭
敖汉小米粥	粥	主食	粥	
整个娃娃菜	浇头	菜品	浇头	
文华鲜虾粥	粥	主食	粥	
文武火白粥	粥	主食	粥	
文火东北大碴子粥	粥	主食	粥	
文火南瓜粥	粥	主食	粥	
文火慢炖白粥	粥	主食	粥	
文火炖萝卜	热菜	菜品	热菜	
文火煲白粥	粥	主食	粥	
文火白米粥	粥	主食	粥	
文火腊八粥	粥	主食	粥	
文火营养白米粥	粥	主食	粥	
文蛤苦瓜汤	汤羹	菜品	汤羹	
文蛤豆腐汤	汤羹	菜品	汤羹	
新品果蔬大拌菜	凉菜	菜品	凉菜	
新品特色八宝粥	粥	主食	粥	
新年清炒西兰花	热菜	菜品	热菜	
新年炝炒圆白菜	热菜	菜品	热菜	
新式炒合菜	热菜	菜品	热菜	
新派南瓜粥	粥	主食	粥	
新派大拌菜	凉菜	菜品	凉菜	
新版皮蛋瘦肉粥	粥	主食	粥	
新疆番茄炖牛腩	热菜	菜品	热菜	
新疆番茄牛肉面	汤面	主食	面	汤面
新疆素抓饭	炒饭	主食	饭	炒饭
新疆阳光大拌菜	凉菜	菜品	凉菜	
新西红柿鸡蛋汤	汤羹	菜品	汤羹	
新鲜乌鸡炖汤	汤羹	菜品	汤羹	
新鲜娃娃菜	蔬菜类	火锅/串串/麻辣烫/色拉自选	配菜	蔬菜类
新鲜嫩白菜	蔬菜类	火锅/串串/麻辣烫/色拉自选	配菜	蔬菜类
新鲜小油菜	浇头	其他	浇头	
新鲜油麦菜	浇头	其他	浇头	
方盒白米饭	白米饭	主食	饭	白米饭
方鱼炒芥兰	热菜	菜品	热菜	
无丝豆角炒肉丝	热菜	菜品	热菜	
无淀粉小米粥	粥	主食	粥	
无淀粉红豆稀饭	粥	主食	粥	
无淀粉肉丸汤	汤羹	菜品	汤羹	
无糖小米南瓜粥	粥	主食	粥	
无糖小米粥	粥	主食	粥	
无糖纯绿豆粥	粥	主食	粥	
无肉滋补鸡汤	汤羹	菜品	汤羹	
无花果炖猪肺	汤羹	菜品	汤羹	
无花果炖瘦肉汤	汤羹	菜品	汤羹	
无花果炖鸡脚	热菜	菜品	热菜	
无花果陈皮炖雪梨	其他甜品	甜点	其他甜品	
日式主题荞麦面	健康餐	色拉轻食	健康餐	
日式乌冬面	其他菜品	其他	面	乌冬面
日式味噌汤	汤羹	菜品	汤羹	
日式小泡菜	凉菜	菜品	凉菜	
日式时蔬炒乌东面	乌冬面	主食	面	乌冬面
日式炒时蔬	热菜	菜品	热菜	
日式玉子乌冬面	乌冬面	主食	面	乌冬面
日式白米饭	白米饭	主食	饭	白米饭
日式荞麦面	凉面	主食	面	凉面
日式菌菇海鲜粥	粥	主食	粥	
日式裙带菜	凉菜	菜品	凉菜	
日式香烤豆腐荞麦面	健康餐	色拉轻食	健康餐	
日式鸡肉粥	粥	主食	粥	
日本乌冬面	乌冬面	主食	面	乌冬面
日本豆腐炒虾仁	热菜	菜品	热菜	
日本豆腐炒青椒	热菜	菜品	热菜	
早点八宝粥	粥	主食	粥	
早点小米粥	粥	主食	粥	
早点绿豆粥	粥	主食	粥	
早点饸络面	汤面	主食	面	汤面
早餐伴侣八宝菜	凉菜	菜品	凉菜	
早餐南瓜粥	粥	主食	粥	
早餐小米粥	粥	主食	粥	
早餐橄榄菜	凉菜	菜品	凉菜	
早餐红糖大米粥	粥	主食	粥	
早餐营养八宝粥	粥	主食	粥	
早餐营养小米粥	粥	主食	粥	
旭光大拌菜	凉菜	菜品	凉菜	
时令大拌菜	凉菜	菜品	凉菜	
时令小份汤	汤羹	菜品	汤羹	
时令炒青蔬	热菜	菜品	热菜	
时令菌菇面	汤面	主食	面	汤面
时令蔬菜粥	粥	主食	粥	
时蔬大三鲜面	汤面	主食	面	汤面
时蔬大拌菜	凉菜	菜品	凉菜	
时蔬小炒皇	热菜	菜品	热菜	
时蔬炒山药	热菜	菜品	热菜	
时蔬炒牛柳	热菜	菜品	热菜	
时蔬炒面加蛋	炒面	主食	面	炒面
时蔬烫青菜	热菜	菜品	热菜	
时蔬疙瘩汤	汤羹	菜品	汤羹	
时蔬白勺青菜	热菜	菜品	热菜	
时蔬绿叶菜	热菜	菜品	热菜	
时蔬茄汁面	汤面	主食	面	汤面
时蔬菌菇面	汤面	主食	面	汤面
时蔬菜泡饭	泡饭	主食	饭	泡饭
时蔬蘸酱菜	凉菜	菜品	凉菜	
时蔬虾仁炒饭	炒饭	主食	饭	炒饭
时蔬虾滑汤	汤羹	菜品	汤羹	
时蔬蛋炒河粉	其他粉	主食	粉	其他粉
时蔬蛋炒饭	炒饭	主食	饭	炒饭
旺旺豆腐汤	汤羹	菜品	汤羹	
昂公豆腐汤	汤羹	菜品	汤羹	
昂刺鱼炖豆腐	热菜	菜品	热菜	
昂刺鱼豆腐汤	汤羹	菜品	汤羹	
昆明高山娃娃菜	蔬菜类	火锅/串串/麻辣烫/色拉自选	配菜	蔬菜类
明太鱼炖豆腐	热菜	菜品	热菜	
明太鱼豆芽粥	粥	主食	粥	
明火瑶柱白粥	粥	主食	粥	
明火靓白粥	粥	主食	粥	
明炉老火煲白粥	粥	主食	粥	
明目枸杞牛肉汤	汤羹	菜品	汤羹	
明目桂圆枸杞粥	粥	主食	粥	
明目红枣枸杞粥	粥	主食	粥	
明虾干贝粥	粥	主食	粥	
明虾虾菇粥	粥	主食	粥	
星爷推荐手打鱼丸汤	汤羹	菜品	汤羹	
春拆骨肉酸菜炖豆腐	热菜	菜品	热菜	
春菜咸骨粥	粥	主食	粥	
春菜排骨粥	粥	主食	粥	
春菜瘦肉粥	粥	主食	粥	
春菜肉末粥	粥	主食	粥	
春饼卷合菜	热菜	菜品	饼/囊/馍	春饼
春饼卷和菜	春饼	主食	饼/囊/馍	春饼
春饼炒合菜	春饼	主食	饼/囊/馍	春饼
晋来顺酸汤面	汤面	主食	面	汤面
晨之味黑米粥	粥	主食	粥	
普宁豆酱炒春菜	热菜	菜品	热菜	
普宁豆酱炒红薯叶	热菜	菜品	热菜	
普普通通干锅花菜	热菜	菜品	热菜	
普通刀削面	其他面	主食	面	其他面
晶莹白玉粥	粥	主食	粥	
暖心八宝粥	粥	主食	粥	
暖心南瓜小米粥	粥	主食	粥	
暖心南瓜粥	粥	主食	粥	
暖心小米南瓜粥	粥	主食	粥	
暖心小米粥	粥	主食	粥	
暖心白米粥	粥	主食	粥	
暖心红枣银耳汤	糖水/炖品	甜点	糖水/炖品	
暖心红豆汤	糖水/炖品	甜点	糖水/炖品	
暖心红豆粥	粥	主食	粥	
暖心红豆黑米粥	粥	主食	粥	
暖心邂逅丨黑米红枣桂圆粥	粥	主食	粥	
暖心银耳汤	糖水/炖品	甜点	糖水/炖品	
暖心黑米粥	粥	主食	粥	
暖暖的小米粥	粥	主食	粥	
暖暖腊八粥	粥	主食	粥	
暖胃小碴粥	粥	主食	粥	
暖胃小米南瓜粥	粥	主食	粥	
暖胃小米粥	粥	主食	粥	
暖胃牛肉低卡饭拌饭	健康餐	色拉轻食	健康餐	
暖胃猪肚鸡汤	汤羹	菜品	汤羹	
暖胃红糖粥	粥	主食	粥	
暖胃红薯粥	粥	主食	粥	
暖胃黑米粥	粥	主食	粥	
曼玲地瓜粥	粥	主食	粥	
曼玲紫薯黑米粥	粥	主食	粥	
曼玲聚福八宝粥	粥	主食	粥	
曼谷炒蔬菜	热菜	菜品	热菜	
最爱南瓜汤	热菜	菜品	热菜	
有一个生菜粥	粥	主食	粥	
有味大拌菜	凉菜	菜品	凉菜	
有机养生鱼丸汤	汤羹	菜品	汤羹	
有机南瓜粥	粥	主食	粥	
有机大白菜	蔬菜类	火锅/串串/麻辣烫/色拉自选	配菜	蔬菜类
有机大碗花菜	热菜	菜品	热菜	
有机娃娃菜	蔬菜类	烧烤	蔬菜类	
有机小米粥	粥	主食	粥	
有机时蔬炒饼	其他主食	主食	其他主食	
有机田园青菜粥	粥	主食	粥	
有机番茄炒蛋	热菜	菜品	热菜	
有机白米饭	白米饭	主食	饭	白米饭
有机米瘦肉粥	粥	主食	粥	
有机花菜炒肉	热菜	菜品	热菜	
有机菜花炒肉	热菜	菜品	热菜	
有机青菜玉米粥	粥	主食	粥	
有机青菜粥	粥	主食	粥	
朝鲜族嫩豆腐汤	汤羹	菜品	汤羹	
朝鲜族拌蕨菜	凉菜	菜品	凉菜	
朝鲜族荞麦冷面	凉面	主食	面	凉面
朝鲜素冷面	凉面	主食	面	凉面
朝鲜荞麦冷面	凉面	主食	面	凉面
朝鲜风味炖鳕鱼	热菜	菜品	热菜	
木桶千叶豆腐饭	木桶饭	主食	饭	木桶饭
木桶蒸米饭	白米饭	主食	饭	白米饭
木瓜养肤粥	粥	主食	粥	
木耳丝瓜炒鸡蛋	热菜	菜品	热菜	
木耳兰豆炒山药	热菜	菜品	热菜	
木耳冬瓜蛋花儿汤	汤羹	菜品	汤羹	
木耳南瓜汤	汤羹	菜品	汤羹	
木耳大白菜	热菜	菜品	热菜	
木耳娃娃菜	热菜	菜品	热菜	
木耳小白菜	热菜	菜品	热菜	
木耳山药炒秋葵	热菜	菜品	热菜	
木耳山药炒肉片	热菜	菜品	热菜	
木耳山药炒虾球	热菜	菜品	热菜	
木耳山药炒青瓜	热菜	菜品	热菜	
木耳拌菠菜	凉菜	菜品	凉菜	
木耳毛葱炒笨鸡蛋	热菜	菜品	热菜	
木耳炒五香干豆腐半份	热菜	菜品	热菜	
木耳炒入主食	浇头	其他	浇头	
木耳炒大白菜	热菜	菜品	热菜	
木耳炒山药	热菜	菜品	热菜	
木耳炒山药小份	热菜	菜品	热菜	
木耳炒山葯	热菜	菜品	热菜	
木耳炒有机花菜	热菜	菜品	热菜	
木耳炒油菜	热菜	菜品	热菜	
木耳炒淮山	热菜	菜品	热菜	
木耳炒牛肉	热菜	菜品	热菜	
木耳炒白菜	蔬菜类	菜品	配菜	蔬菜类
木耳炒白菜干豆腐	热菜	菜品	热菜	
木耳炒白菜片	热菜	菜品	热菜	
木耳炒肉丝	热菜	菜品	热菜	
木耳炒肉沫	热菜	菜品	热菜	
木耳炒肉煲仔	煲仔饭	主食	饭	煲仔饭
木耳炒肉片	热菜	菜品	热菜	
木耳炒肉盖浇饭	盖浇饭	主食	饭	盖浇饭
木耳炒肉盖饭	盖浇饭	主食	饭	盖浇饭
木耳炒肉面	盖浇面	主食	面	盖浇面
木耳炒肉饭	盖浇饭	主食	饭	盖浇饭
木耳炒腐竹	热菜	菜品	热菜	
木耳炒芹菜	热菜	菜品	热菜	
木耳炒藕片	热菜	菜品	热菜	
木耳炒蛋盖米	盖浇饭	主食	饭	盖浇饭
木耳炒蛋盖饭	盖浇饭	主食	饭	盖浇饭
木耳炒蛋粉干	米线	主食	粉	米线
木耳炒蛋饭	盖浇饭	主食	饭	盖浇饭
木耳炒西兰花	热菜	菜品	热菜	
木耳炒青菜	热菜	菜品	热菜	
木耳炒香菇	凉菜	菜品	凉菜	
木耳炒鸡蛋	热菜	菜品	热菜	
木耳炒鸡蛋小份	热菜	菜品	热菜	
木耳烧白菜	热菜	菜品	热菜	
木耳甜豆炒山药	热菜	菜品	热菜	
木耳甜豆炒百合	热菜	菜品	热菜	
木耳白菜炒肉	热菜	菜品	热菜	
木耳白菜爆豆腐小碗菜	热菜	菜品	热菜	
木耳肉丝加米饭	其他菜品	其他	其他菜品	
木耳肉丝套饭	其他饭	主食	饭	其他饭
木耳肉丝盖浇饭	盖浇饭	主食	饭	盖浇饭
木耳肉丝豆腐汤	汤羹	菜品	汤羹	
木耳肉丝面	汤面	主食	面	汤面
木耳肉丝饭	盖浇饭	主食	饭	盖浇饭
木耳肉片盖饭	盖浇饭	主食	饭	盖浇饭
木耳肉片饭	盖浇饭	主食	饭	盖浇饭
木耳肉蓉汤	汤羹	菜品	汤羹	
木耳荷兰豆炒山药	热菜	菜品	热菜	
木耳荷兰豆炒肉片	热菜	菜品	热菜	
木耳西芹肉丝饭	盖浇饭	主食	饭	盖浇饭
木耳青椒肉丝盖饭	盖浇饭	主食	饭	盖浇饭
木耳面筋冷面	凉面	主食	面	凉面
木耳面筋面	汤面	主食	面	汤面
木耳鸡柳盖饭	盖浇饭	主食	饭	盖浇饭
木耳鸡蛋炒瓜片	热菜	菜品	热菜	
木耳鸡蛋炒肉	热菜	菜品	热菜	
木耳鸡蛋炒菜	热菜	菜品	热菜	
木耳鸡蛋盖饭	盖浇饭	主食	饭	盖浇饭
木耳鸡蛋饭	盖浇饭	主食	饭	盖浇饭
木耳黄瓜丝炒鸡蛋	热菜	菜品	热菜	
木耳黄瓜拌饭	拌饭	主食	饭	拌饭
木耳黄花菜	热菜	菜品	热菜	
木须小油菜	热菜	菜品	热菜	
木须小白菜	热菜	菜品	热菜	
木须打卤面	盖浇面	主食	面	盖浇面
木须柿子汤	汤羹	菜品	汤羹	
木须柿子浇汁饭	盖浇饭	主食	饭	盖浇饭
木须柿子炒面	炒面	主食	面	炒面
木须柿子盖浇饭	盖浇饭	主食	饭	盖浇饭
木须柿子盖饭	盖浇饭	主食	饭	盖浇饭
木须柿子饭	盖浇饭	主食	饭	盖浇饭
木须瓜片小份带米饭	热菜	菜品	热菜	
木须瓜片汤	汤羹	菜品	汤羹	
木须瓜片盖饭	盖浇饭	主食	饭	盖浇饭
木须肉十米饭	其他菜品	其他	其他菜品	
木须肉小份菜	热菜	菜品	热菜	
木须肉小炒	热菜	菜品	热菜	
木须肉小炒加米饭	盖浇饭	主食	饭	盖浇饭
木须肉炒菜	热菜	菜品	热菜	
木须肉片盖浇饭	盖浇饭	主食	饭	盖浇饭
木须肉盖浇饭	盖浇饭	主食	饭	盖浇饭
木须苦瓜炒虾仁	热菜	菜品	热菜	
木须黄瓜小碗菜	凉菜	菜品	凉菜	
木须黄瓜盖饭	盖浇饭	主食	饭	盖浇饭
本地姜汤面	汤面	主食	面	汤面
本地小青菜	蔬菜类	火锅/串串/麻辣烫/色拉自选	配菜	蔬菜类
本地山羊纯羊肉汤	汤羹	菜品	汤羹	
本地毛青菜	热菜	菜品	热菜	
本地老鸭索面	汤面	主食	面	汤面
本地芹菜炒肉	热菜	菜品	热菜	
本家老娘疙瘩汤	汤羹	菜品	汤羹	
本帮长寿菜	凉菜	菜品	凉菜	
本店秘制酸包菜	热菜	菜品	热菜	
术后清炖乌鸡汤	汤羹	菜品	汤羹	
术后鸽子汤	汤羹	菜品	汤羹	
朴素的蛋炒饭	炒饭	主食	饭	炒饭
朴素鲜菌汤	汤羹	菜品	汤羹	
杂丸粗粮面	汤面	主食	面	汤面
杂磨炒土豆片	热菜	菜品	热菜	
杂粮八宝粥	粥	主食	粥	
杂粮包外婆菜	馒头	主食	馒头	
杂粮外婆菜	热菜	菜品	热菜	
杂粮黑米粥	粥	主食	粥	
杂菜肉丝蛋汤	汤羹	菜品	汤羹	
杂锦紫菜汤	汤羹	菜品	汤羹	
杂骨海带汤	汤羹	菜品	汤羹	
李连贵蛋花汤	汤羹	菜品	汤羹	
杏仁炒豆腐	热菜	菜品	热菜	
杏仁瓜子粥	粥	主食	粥	
杏仁百合炖猪肺	汤羹	菜品	汤羹	
杏包菇现炒	热菜	菜品	热菜	
杏鲍菇丝炒肉	热菜	菜品	热菜	
杏鲍菇丝炒肉丝	热菜	菜品	热菜	
杏鲍菇炒瘦肉片	热菜	菜品	热菜	
杏鲍菇炒肉	热菜	菜品	热菜	
杏鲍菇炒肉丝	热菜	菜品	热菜	
杏鲍菇炒肉片	热菜	菜品	热菜	
杏鲍菇炒茼蒿	热菜	菜品	热菜	
杏鲍菇炒菜心	热菜	菜品	热菜	
杏鲍菇炒蒜苗	热菜	菜品	热菜	
杏鲍菇炒蛋	热菜	菜品	热菜	
杏鲍菇炒青菜	热菜	菜品	热菜	
杏鲍菇炒韭菜	热菜	菜品	热菜	
杏鲍菇炒香芹	热菜	菜品	热菜	
杏鲍菇炒鸡丁	热菜	菜品	热菜	
杏鲍菇炒鸡柳	热菜	菜品	热菜	
杏鲍菇炒鸡蛋	热菜	菜品	热菜	
杏鲍菇炒龙豆丝	热菜	菜品	热菜	
杏鲍菇菇炒肉	热菜	菜品	热菜	
来一份晶莹如玉的小白菜	浇头	其他	浇头	
来一份米饭	白米饭	主食	饭	白米饭
来一碗热气腾腾的紫菜蛋花汤	汤羹	菜品	汤羹	
来自黑土地的东北大米饭	白米饭	主食	饭	白米饭
来自黑土地的米饭	白米饭	主食	饭	白米饭
杭州小馄炖	馄饨	主食	馄饨	
杭椒沫炒鸡蛋	热菜	菜品	热菜	
杭椒炒土鸡蛋	热菜	菜品	热菜	
杭椒炒杭茄	热菜	菜品	热菜	
杭椒炒蛋饭	盖浇饭	主食	饭	盖浇饭
杭椒炒鸡蛋	热菜	菜品	热菜	
杭椒酱炒鸡蛋	热菜	菜品	热菜	
杭白菜炒口蘑	热菜	菜品	热菜	
杭白菜炒豆皮	热菜	菜品	热菜	
杭风香锅卷心菜	热菜	菜品	热菜	
杯式八宝粥	粥	主食	粥	
杯式红豆粥	粥	主食	粥	
杯装八宝粥	粥	主食	粥	
杯装南瓜粥	粥	主食	粥	
杯装小米粥	粥	主食	粥	
杯装本色绿豆粥	粥	主食	粥	
杯装燕麦粥	粥	主食	粥	
杯装紫米红豆粥	粥	主食	粥	
杯装红豆粥	粥	主食	粥	
杯装蛋花汤	汤羹	菜品	汤羹	
杯装黑米粥	粥	主食	粥	
松仁炒玉米	热菜	菜品	热菜	
松仁炒茼蒿	热菜	菜品	热菜	
松仁玉米炒山药	热菜	菜品	热菜	
松仁玉米盖饭	盖浇饭	主食	饭	盖浇饭
松仁黑芝麻糊粥	粥	主食	粥	
松娥炖山药	热菜	菜品	热菜	
松峨炖山药	热菜	菜品	热菜	
松江大米饭	白米饭	主食	饭	白米饭
松籽炒玉米	热菜	菜品	热菜	
松肉白菜炖粉条	热菜	菜品	热菜	
松茸双菇面	汤面	主食	面	汤面
松茸土鸡汤	汤羹	菜品	汤羹	
松茸炖乳鸽汤	汤羹	菜品	汤羹	
松茸石锅豆腐汤	热菜	菜品	热菜	
松茸菌丸子汤	汤羹	菜品	汤羹	
松茸菌炖猪骨	汤羹	菜品	汤羹	
松茸菌菇汤	汤羹	菜品	汤羹	
松茸鲜汤面	汤面	主食	面	汤面
松菇炒小白菜	热菜	菜品	热菜	
板栗乌鸡汤	汤羹	菜品	汤羹	
板栗乌鸡煨汤	汤羹	菜品	汤羹	
板栗仁南瓜粥	粥	主食	粥	
板栗削骨肉粥	粥	主食	粥	
板栗桂圆黑米枸杞粥	粥	主食	粥	
板栗炖鸡汤	汤羹	菜品	汤羹	
板栗炖鸭肉	热菜	菜品	热菜	
板栗猪骨汤	汤羹	菜品	汤羹	
板栗紫薯粥	粥	主食	粥	
板栗红豆粥	粥	主食	粥	
板栗肉片粥	粥	主食	粥	
板栗香芋粥	粥	主食	粥	
板栗香菇炖土鸡汤豪华套餐	汤羹	菜品	汤羹	
板栗鸡丝粥	粥	主食	粥	
板烧娃娃菜	热菜	菜品	热菜	
枇杷烤梨银耳汤	其他甜品	甜点	其他甜品	
果仁拌菠菜	凉菜	菜品	凉菜	
果仁炝菠菜	热菜	菜品	热菜	
果味大拌菜	凉菜	菜品	凉菜	
果蔬大拌菜	凉菜	菜品	凉菜	
枣园清炖土鸡普烩半只	热菜	菜品	热菜	
枣园清炖土鸡普烩整只	热菜	菜品	热菜	
枣园清炖土鸡精烩半只	热菜	菜品	热菜	
枸杞三及第汤	汤羹	菜品	汤羹	
枸杞乌鸡汤	汤羹	菜品	汤羹	
枸杞乌鸡补血汤	汤羹	菜品	汤羹	
枸杞南瓜粥	粥	主食	粥	
枸杞叶及第汤	汤羹	菜品	汤羹	
枸杞叶小肠汤	汤羹	菜品	汤羹	
枸杞叶猪杂汤	汤羹	菜品	汤羹	
枸杞叶猪肝粥	粥	主食	粥	
枸杞叶瘦肉汤	汤羹	菜品	汤羹	
枸杞咸蛋粥	粥	主食	粥	
枸杞土鸡汤	汤羹	菜品	汤羹	
枸杞大枣山药粥	粥	主食	粥	
枸杞大枣粥	粥	主食	粥	
枸杞大枣荷叶粥	粥	主食	粥	
枸杞大骨汤	汤羹	菜品	汤羹	
枸杞小米粥	粥	主食	粥	
枸杞桂圆粥	粥	主食	粥	
枸杞炖乌鸡汤	汤羹	菜品	汤羹	
枸杞燕麦小米粥	粥	主食	粥	
枸杞燕麦粥	粥	主食	粥	
枸杞猪心汤	汤羹	菜品	汤羹	
枸杞米粉汤	米线	主食	粉	米线
枸杞红枣粥	粥	主食	粥	
枸杞红枣红糖粥	粥	主食	粥	
枸杞红枣银耳汤	糖水/炖品	甜点	糖水/炖品	
枸杞老鸭汤	汤羹	菜品	汤羹	
枸杞菜土鸡蛋汤	汤羹	菜品	汤羹	
枸杞银耳汤	糖水/炖品	甜点	糖水/炖品	
枸杞鲜银耳汤	糖水/炖品	甜点	糖水/炖品	
枸杞鸽子汤	汤羹	菜品	汤羹	
柏杨豆干炒肉丝	热菜	菜品	热菜	
柒五大拌菜	凉菜	菜品	凉菜	
柴火乌冬面	乌冬面	主食	面	乌冬面
柴火炖自制豆腐	热菜	菜品	热菜	
柴鸡炖蘑菇	热菜	菜品	热菜	
柴鸡蛋炒虾仁	热菜	菜品	热菜	
柿子土豆菠菜	热菜	菜品	热菜	
柿子椒炒鸡丁	热菜	菜品	热菜	
柿子炒鸡蛋	热菜	菜品	热菜	
柿子炒鸡蛋小份	热菜	菜品	热菜	
柿子瓜片鸡蛋汤	汤羹	菜品	汤羹	
柿子蛋花汤	汤羹	菜品	汤羹	
柿子鸡蛋打卤面	盖浇面	主食	面	盖浇面
柿子鸡蛋汤	汤羹	菜品	汤羹	
柿子鸡蛋盖米饭	盖浇饭	主食	饭	盖浇饭
栀子花炒肉	热菜	菜品	热菜	
树菇老鸭汤	汤羹	菜品	汤羹	
树菇老鸭面	汤面	主食	面	汤面
核桃仁蛋汤	糖水/炖品	甜点	糖水/炖品	
核桃南瓜粥	粥	主食	粥	
核桃枸杞炒牛柳	热菜	菜品	热菜	
核桃枸杞粥	粥	主食	粥	
核桃栗子粥	粥	主食	粥	
核桃桂圆栗子粥	粥	主食	粥	
核桃桂圆粥	粥	主食	粥	
核桃桂圆红枣粥	粥	主食	粥	
核桃燕麦粥	粥	主食	粥	
核桃红枣山药粥	粥	主食	粥	
核桃红枣枸杞粥	粥	主食	粥	
核桃红枣桂圆粥	粥	主食	粥	
核桃红枣粥	粥	主食	粥	
核桃莲子山药粥	粥	主食	粥	
核桃莲子粥	粥	主食	粥	
核桃莲子黑米粥	粥	主食	粥	
核桃薏仁桂圆莲子粥	粥	主食	粥	
核桃鸭蛋汤	糖水/炖品	甜点	糖水/炖品	
桂圆八宝粥	粥	主食	粥	
桂圆山药粥	粥	主食	粥	
桂圆枸杞粥	粥	主食	粥	
桂圆枸杞银耳粥	粥	主食	粥	
桂圆枸杞鸡蛋汤	汤羹	菜品	汤羹	
桂圆核桃粥	粥	主食	粥	
桂圆核桃红糖粥	粥	主食	粥	
桂圆百合银耳粥	粥	主食	粥	
桂圆红枣乌鸡汤	汤羹	菜品	汤羹	
桂圆红枣味莲子粥	粥	主食	粥	
桂圆红枣小米粥	粥	主食	粥	
桂圆红枣汤	糖水/炖品	甜点	糖水/炖品	
桂圆红枣粥	粥	主食	粥	
桂圆红枣花生汤	糖水/炖品	甜点	糖水/炖品	
桂圆红枣花生粥	粥	主食	粥	
桂圆红枣莲子粥	粥	主食	粥	
桂圆红枣葡萄粥	粥	主食	粥	
桂圆红豆枸杞粥	粥	主食	粥	
桂圆红豆粥	粥	主食	粥	
桂圆花生红枣汤	糖水/炖品	甜点	糖水/炖品	
桂圆莲子八宝粥	粥	主食	粥	
桂圆莲子养生粥	粥	主食	粥	
桂圆莲子汤	糖水/炖品	甜点	糖水/炖品	
桂圆莲子粥	粥	主食	粥	
桂圆莲子红枣粥	粥	主食	粥	
桂圆莲子红豆汤	糖水/炖品	甜点	糖水/炖品	
桂圆莲藕山药粥	粥	主食	粥	
桂圆银耳汤	汤羹	菜品	汤羹	
桂圆银耳粥	粥	主食	粥	
桂圆鸡蛋汤	汤羹	菜品	汤羹	
桂花八宝粥	粥	主食	粥	
桂花养胃粥	粥	主食	粥	
桂花山药粥	粥	主食	粥	
桂花炖桃胶	其他甜品	甜点	其他甜品	
桂花番薯汤	糖水/炖品	甜点	糖水/炖品	
桂花百合粥	粥	主食	粥	
桂花百合糯米粥	粥	主食	粥	
桂花紫米粥	粥	主食	粥	
桂花红枣粥	粥	主食	粥	
桂花红枣阴米粥	粥	主食	粥	
桂花红薯枸杞粥	粥	主食	粥	
桂花红薯粥	粥	主食	粥	
桂花红豆粥	粥	主食	粥	
桂花莲子粥	粥	主食	粥	
桂花莲藕粥	糖水/炖品	甜点	糖水/炖品	
桂花蜜枣粥	粥	主食	粥	
桂花蜜鲜炖红枣银耳羹	糖水/炖品	甜点	糖水/炖品	
桂花赤豆粥	粥	主食	粥	
桂花银耳汤	糖水/炖品	甜点	糖水/炖品	
桂花银耳雪梨汤	其他甜品	甜点	其他甜品	
桂花雪梨圆子粥	粥	主食	粥	
桂花鸡蛋汤	汤羹	菜品	汤羹	
桂花黑米粥	粥	主食	粥	
桃仁八宝粥	粥	主食	粥	
桃仁百合炒芦笋	热菜	菜品	热菜	
桃源卷饼菜	卷饼	主食	饼/囊/馍	卷饼
桃胶炖木瓜	其他甜品	甜点	其他甜品	
桃胶莲子炖奶	其他甜品	甜点	其他甜品	
桑椹陈皮汤	其他菜品	其他	其他菜品	
梅干菜炒肉	热菜	菜品	热菜	
梅干菜炒苦瓜肉沫	热菜	菜品	热菜	
梅干菜炒莲藕	热菜	菜品	热菜	
梅菜笋丝小菜	凉菜	菜品	凉菜	
梅菜肉末炒豆角	热菜	菜品	热菜	
梅豆炒土豆	热菜	菜品	热菜	
梧桐花炒韭菜鸡蛋	热菜	菜品	热菜	
梨花蔬菜拌饭	拌饭	主食	饭	拌饭
棒子骨莲白汤	汤羹	菜品	汤羹	
棒渣红薯粥	粥	主食	粥	
棕香长粒香米饭	白米饭	主食	饭	白米饭
森林菌类小炒	热菜	菜品	热菜	
椒丝腐乳空心菜	热菜	菜品	热菜	
椒丝腐乳通心菜	热菜	菜品	热菜	
椒油圆白菜	热菜	菜品	热菜	
椒麻圆白菜	热菜	菜品	热菜	
椒麻大拌菜	凉菜	菜品	凉菜	
椰奶南瓜小米粥	粥	主食	粥	
椰奶燕麦粥	粥	主食	粥	
椰奶红枣燕麦粥	粥	主食	粥	
椰奶西米红豆粥	粥	主食	粥	
椰奶麦片粥	粥	主食	粥	
椰子乌鸡汤	汤羹	菜品	汤羹	
椰果椰奶粥	粥	主食	粥	
椰汁炖雪燕	其他甜品	甜点	其他甜品	
椰汁红豆百合莲子冰粥	粥	主食	粥	
椰油炒荷兰豆	热菜	菜品	热菜	
椰肉乌鸡汤	汤羹	菜品	汤羹	
楠园炒三丝	热菜	菜品	热菜	
楠溪土豆麦面	汤面	主食	面	汤面
榄菜炒脆笋	热菜	菜品	热菜	
榄菜百合炒蚕豆	热菜	菜品	热菜	
榄菜肉末四季豆饭	盖浇饭	主食	饭	盖浇饭
榄菜肉末炒豆角	热菜	菜品	热菜	
榄菜肉末炒豇豆	热菜	菜品	热菜	
榄菜菌菇饭	炒饭	主食	饭	炒饭
榆树面热汤	汤面	主食	面	汤面
榛蘑炒土豆片	热菜	菜品	热菜	
榨广椒炒蛋	热菜	菜品	热菜	
榨菜炒豆芽	热菜	菜品	热菜	
榨菜炒银芽	热菜	菜品	热菜	
榨菜炒鸡蛋	热菜	菜品	热菜	
榨菜炒黄豆芽	热菜	菜品	热菜	
榨菜番茄肉丝汤	汤羹	菜品	汤羹	
榨菜番茄蛋花汤	汤羹	菜品	汤羹	
榨菜肉丝炒豆芽	热菜	菜品	热菜	
榨菜肉丝粥	粥	主食	粥	
榨菜肉丝青菜汤	汤羹	菜品	汤羹	
榨菜蛋花汤	汤羹	菜品	汤羹	
榨菜西红柿汤	汤羹	菜品	汤羹	
榨菜豆腐汤	汤羹	菜品	汤羹	
榨菜鸡蛋汤	汤羹	菜品	汤羹	
槐树花炒土鸡蛋	热菜	菜品	热菜	
槐米南瓜红枣粥	粥	主食	粥	
槐米小米粥	粥	主食	粥	
槐花炒鸡蛋	热菜	菜品	热菜	
樱花虾拌娃娃菜	凉菜	菜品	凉菜	
樱花虾炒莲白	热菜	菜品	热菜	
橄榄油养生菜	热菜	菜品	热菜	
橄榄油大拌菜	凉菜	菜品	凉菜	
橄榄油时蔬炒虾仁	热菜	菜品	热菜	
橄榄油炒三种蘑菇	蔬菜类	菜品	配菜	蔬菜类
橄榄油炒时令蔬菜	热菜	菜品	热菜	
橄榄油炒时蔬	热菜	菜品	热菜	
橄榄油炒杂菌素珍	热菜	菜品	热菜	
橄榄油炒田园时蔬	热菜	菜品	热菜	
橄榄油炒素什锦	热菜	菜品	热菜	
橄榄油炒芦笋	热菜	菜品	热菜	
橄榄油菠菜	热菜	菜品	热菜	
橄榄瘦肉薏米汤	汤羹	菜品	汤羹	
橄榄菜炒四季豆	热菜	菜品	热菜	
橄榄菜炒四季豆盖饭	盖浇饭	主食	饭	盖浇饭
橄榄菜炒脆笋	热菜	菜品	热菜	
橄榄菜炒豆角	热菜	菜品	热菜	
橄榄菜蛋炒饭	炒饭	主食	饭	炒饭
欧巴裙带汤	汤羹	菜品	汤羹	
正义八宝粥	粥	主食	粥	
正宗东北大碴子粥	粥	主食	粥	
正宗东北大米饭	白米饭	主食	饭	白米饭
正宗五常香米饭	白米饭	主食	饭	白米饭
正宗双柳鱼丸汤	汤羹	菜品	汤羹	
正宗古法八宝粥	粥	主食	粥	
正宗嵊泗枸杞淡菜	热菜	菜品	热菜	
正宗手工米面	米线	主食	粉	米线
正宗木桶蒸的米饭	白米饭	主食	饭	白米饭
正宗沂蒙炒鸡加土豆片	热菜	菜品	热菜	
正宗河南风味胡辣汤	汤羹	菜品	汤羹	
正宗潮汕牛肉丸汤	汤羹	菜品	汤羹	
正宗潮汕鱼丸汤面	汤面	主食	面	汤面
正宗盘锦大米饭	白米饭	主食	饭	白米饭
每日老火例汤	汤羹	菜品	汤羹	
比管炖白菜豆腐	热菜	菜品	热菜	
比管炖豆腐	热菜	菜品	热菜	
比管鱼炖豆腐	热菜	菜品	热菜	
毛哥老鸭汤	汤羹	菜品	汤羹	
毛毛菜豆腐汤	汤羹	菜品	汤羹	
毛白菜拌面	拌面	主食	面	拌面
毛芋丝炒青椒	热菜	菜品	热菜	
毛葱木耳炒鸡蛋	热菜	菜品	热菜	
毛葱炒鸡蛋	热菜	菜品	热菜	
毛蛤蜊拌菠菜	凉菜	菜品	凉菜	
毛豆婆婆菜	凉菜	菜品	凉菜	
毛豆炒丝瓜	热菜	菜品	热菜	
毛豆炒瘦肉	热菜	菜品	热菜	
毛豆炒肉丝	热菜	菜品	热菜	
毛豆炒肉沫	热菜	菜品	热菜	
毛豆炒萝卜干	热菜	菜品	热菜	
毛豆米炒外婆菜	热菜	菜品	热菜	
毛豆米炒肉丝	热菜	菜品	热菜	
毛豆米炒香干	热菜	菜品	热菜	
毛豆米炒鸡蛋	热菜	菜品	热菜	
毛豆雪菜炒肉丝	热菜	菜品	热菜	
毛豆香干炒肉丝	热菜	菜品	热菜	
水冬菜炒蘑菇	热菜	菜品	热菜	
水晶粉炒包菜	热菜	菜品	热菜	
水晶香米饭	白米饭	主食	饭	白米饭
水果什锦汤	其他甜品	甜点	其他甜品	
水果多多四果汤	其他甜品	甜点	其他甜品	
水果黑米粥	粥	主食	粥	
水潺红烧芹菜	热菜	菜品	热菜	
水灵灵六种蘸酱菜	凉菜	菜品	凉菜	
水烙馍卷菜	卷饼	主食	饼/囊/馍	卷饼
水煮圆白菜	热菜	菜品	热菜	
水煮大白菜	热菜	菜品	热菜	
水煮娃娃菜	热菜	菜品	热菜	
水牛奶鲜炖桃胶	其他甜品	甜点	其他甜品	
水磨绿豆锅巴菜	其他菜品	其他	其他菜品	
水芹炒干丝	热菜	菜品	热菜	
水芹炒百叶	热菜	菜品	热菜	
水芹炒香干	热菜	菜品	热菜	
水芹菜炒百叶	热菜	菜品	热菜	
水芹菜炒香干	热菜	菜品	热菜	
水萝卜炖贝丁	热菜	菜品	热菜	
水萝卜疙瘩汤	汤羹	菜品	汤羹	
水豆腐带米饭	白米饭	主食	饭	白米饭
水饺猪肉芹菜	饺子	主食	饺子	
水鱼豆腐汤	汤羹	菜品	汤羹	
永乐萝卜丸子汤	汤羹	菜品	汤羹	
永和牌黑米粥	粥	主食	粥	
永和苞米粥	粥	主食	粥	
永和黑米粥	粥	主食	粥	
永春白鸭汤	汤羹	菜品	汤羹	
永春石鼓白鸭汤	热菜	菜品	热菜	
永超长粒香米饭	白米饭	主食	饭	白米饭
汇丰一品粥	粥	主食	粥	
汇丰大拌菜	凉菜	菜品	凉菜	
汉菜古炖豆腐	热菜	菜品	热菜	
汕头手捶牛肉丸紫菜汤	汤羹	菜品	汤羹	
汕头橄榄菜炒脆四季豆	热菜	菜品	热菜	
汕头芥蓝炒鲜牛肉	热菜	菜品	热菜	
江南小炒菜花	热菜	菜品	热菜	
江苏米白米饭	白米饭	主食	饭	白米饭
江西贡米饭	白米饭	主食	饭	白米饭
汤里不放香菜	蔬菜类	火锅/串串/麻辣烫/色拉自选	配菜	蔬菜类
汤里加小青菜	浇头	其他	浇头	
汤里加小青菜小青菜小青菜	浇头	其他	浇头	
汤里加点香菜	浇头	其他	浇头	
汤里加紫菜	浇头	其他	浇头	
汤里加青菜	浇头	其他	浇头	
汤里另加娃娃菜	浇头	其他	浇头	
沁州黄小米粥	粥	主食	粥	
沁源松磨炖豆腐	热菜	菜品	热菜	
沂卅小米粥	粥	主食	粥	
沂蒙山炒鸡	热菜	菜品	热菜	
沂蒙疙瘩汤	汤羹	菜品	汤羹	
沅江清水面	其他面	主食	面	其他面
沈老头特色八宝粥	粥	主食	粥	
沈阳小炒豆芽	热菜	菜品	热菜	
沈阳拌花菜	凉菜	菜品	凉菜	
沙县猪肚汤	汤羹	菜品	汤羹	
沙参玉竹炖猪肺	汤羹	菜品	汤羹	
沙拉大拌菜	凉菜	菜品	凉菜	
沙拉玉米紫菜包饭	其他饭	主食	饭	其他饭
沙棘蛋花汤	汤羹	菜品	汤羹	
沙煲娃娃菜	热菜	菜品	热菜	
沙煲小炒花菜	热菜	菜品	热菜	
沙煲手撕包菜	热菜	菜品	热菜	
沙瓤西红柿鸡蛋卤面	盖浇面	主食	面	盖浇面
沙盖炒豆腐	热菜	菜品	热菜	
沙茶高丽菜	热菜	菜品	热菜	
沙葱炒农家鸡蛋	热菜	菜品	热菜	
沙葱炒土鸡蛋	热菜	菜品	热菜	
沙葱炒鸡蛋	热菜	菜品	热菜	
沙虾砂锅粥	粥	主食	粥	
沙蛤肉炒芹菜	热菜	菜品	热菜	
沙蛤苦瓜汤	汤羹	菜品	汤羹	
沙螺苦瓜汤	汤羹	菜品	汤羹	
河虾干炒小土豆	热菜	菜品	热菜	
河虾炒娃娃菜	热菜	菜品	热菜	
河虾豆腐汤	汤羹	菜品	汤羹	
油冬菜炒泡豆腐	热菜	菜品	热菜	
油泡大白菜	热菜	菜品	热菜	
油泼娃娃菜	热菜	菜品	热菜	
油泼菠菜面	其他面	主食	面	其他面
油泼西红柿面	其他面	主食	面	其他面
油淋娃娃菜	热菜	菜品	热菜	
油淋空心菜	热菜	菜品	热菜	
油渍大白菜	热菜	菜品	热菜	
油渣云南小白菜	热菜	菜品	热菜	
油渣小白菜	热菜	菜品	热菜	
油渣榛蘑小白菜	热菜	菜品	热菜	
油渣炖萝卜	热菜	菜品	热菜	
油炒梅菜笋	热菜	菜品	热菜	
油炒萝卜干	热菜	菜品	热菜	
油焖八宝菜	热菜	菜品	热菜	
油焖小青菜	热菜	菜品	热菜	
油焖豆腐大头菜	热菜	菜品	热菜	
油菜土豆豆角焖面	焖面	主食	面	焖面
油菜炒虾米	热菜	菜品	热菜	
油菜炒鸡蛋	热菜	菜品	热菜	
油菜鸡蛋素炒面	炒面	主食	面	炒面
油豆皮小白菜	热菜	菜品	热菜	
油豆腐丨炖了一个小时	热菜	菜品	热菜	
油豆腐娃娃娃菜	热菜	菜品	热菜	
油豆腐小碗菜	热菜	菜品	热菜	
油豆腐泡炒芹菜	热菜	菜品	热菜	
油豆腐炒大白菜	热菜	菜品	热菜	
油豆腐炒蒜苗	热菜	菜品	热菜	
油豆腐炒青菜	热菜	菜品	热菜	
油豆腐烧大白菜	热菜	菜品	热菜	
油豆腐粉丝汤	其他粉	主食	粉	其他粉
油豆腐青菜	热菜	菜品	热菜	
油豆角炖瘦肉	热菜	菜品	热菜	
油醋罗马生菜	热菜	菜品	热菜	
油闷海白菜	热菜	菜品	热菜	
油面筋炒丝瓜	热菜	菜品	热菜	
油麦菜丨香水生菜	蔬菜类	火锅/串串/麻辣烫/色拉自选	配菜	蔬菜类
油麦菜稀饭	粥	主食	粥	
泉州水丸汤	汤羹	菜品	汤羹	
泉水炖绣球菌汤	汤羹	菜品	汤羹	
法式豌豆浓汤	汤羹	菜品	汤羹	
泡菜嫩豆腐汤	汤羹	菜品	汤羹	
泡菜炒冬瓜	热菜	菜品	热菜	
泡菜炒土豆	热菜	菜品	热菜	
泡菜炒魔芋	热菜	菜品	热菜	
泡菜豆腐汤	汤羹	菜品	汤羹	
泡藕代炒猪肚	热菜	菜品	热菜	
波菜炒鸡蛋	热菜	菜品	热菜	
波菜鸡蛋汤	汤羹	菜品	汤羹	
泰国白米饭	白米饭	主食	饭	白米饭
泰国茉莉花香米饭	白米饭	主食	饭	白米饭
泰国香米饭	白米饭	主食	饭	白米饭
泰式时蔬炒野菌	热菜	菜品	热菜	
泰式炒时蔬	热菜	菜品	热菜	
泰式炒杂菜	热菜	菜品	热菜	
泰式炒通菜	热菜	菜品	热菜	
泰式秋葵炒蛋	热菜	菜品	热菜	
泰金香白粥	粥	主食	粥	
泰顺农家炖笋干	热菜	菜品	热菜	
洋参乌鸡汤	汤羹	菜品	汤羹	
洋参炖乌鸡汤	汤羹	菜品	汤羹	
洋参田七炖竹丝鸡	热菜	菜品	热菜	
洋柿子炒土豆丝	热菜	菜品	热菜	
洋柿子炒菜花	热菜	菜品	热菜	
洋柿子炒鸡蛋	热菜	菜品	热菜	
洋白菜炒粉条	热菜	菜品	热菜	
洋白菜炒饼	其他主食	主食	其他主食	
洋白菜素炒饼	其他主食	主食	其他主食	
洋白菜鸡蛋炒面	炒面	主食	面	炒面
洋白菜鸡蛋炒饼	其他主食	主食	其他主食	
洋芋糊糊面	汤面	主食	面	汤面
洋葱土豆牛肉饭	盖浇饭	主食	饭	盖浇饭
洋葱木耳炒肉	热菜	菜品	热菜	
洋葱木耳炒肉片	热菜	菜品	热菜	
洋葱炒土豆	热菜	菜品	热菜	
洋葱炒土豆片	热菜	菜品	热菜	
洋葱炒木耳	热菜	菜品	热菜	
洋葱炒本地土豆	热菜	菜品	热菜	
洋葱炒牛肉	热菜	菜品	热菜	
洋葱炒肉丝	热菜	菜品	热菜	
洋葱炒肉片	热菜	菜品	热菜	
洋葱炒肉盖浇面	盖浇面	主食	面	盖浇面
洋葱炒肉盖浇饭	盖浇饭	主食	饭	盖浇饭
洋葱炒肉盖码饭	盖浇饭	主食	饭	盖浇饭
洋葱炒肉盖饭	盖浇饭	主食	饭	盖浇饭
洋葱炒蛋盖浇面	盖浇面	主食	面	盖浇面
洋葱炒蛋盖浇饭	盖浇饭	主食	饭	盖浇饭
洋葱炒蛋饭	盖浇饭	主食	饭	盖浇饭
洋葱炒豆腐干	热菜	菜品	热菜	
洋葱炒酱干	热菜	菜品	热菜	
洋葱炒饼丝	其他主食	主食	其他主食	
洋葱炒鸡蛋	热菜	菜品	热菜	
洋葱炒鸡蛋小份	热菜	菜品	热菜	
洋葱炒鸡蛋盖浇饭	盖浇饭	主食	饭	盖浇饭
洋葱炒鸡蛋盖饭	盖浇饭	主食	饭	盖浇饭
洋葱牛肉丝饭	盖浇饭	主食	饭	盖浇饭
洋葱肉丝饭	盖浇饭	主食	饭	盖浇饭
洋葱鸡蛋炒面	炒面	主食	面	炒面
洋葱鸡蛋盖浇饭	盖浇饭	主食	饭	盖浇饭
洞头本地紫菜汤	汤羹	菜品	汤羹	
津味炒合菜	热菜	菜品	热菜	
津味炒合菜大份	热菜	菜品	热菜	
津味炒合菜小份	热菜	菜品	热菜	
津味素豆芽菜	其他包子	主食	包子	其他包子
津门炒合菜	热菜	菜品	热菜	
活蹦娃娃菜	蔬菜类	烧烤	蔬菜类	
浆水菜炒软饼	热菜	菜品	热菜	
浆水菜蛋炒饼	其他主食	主食	其他主食	
浆水豆花汤	汤羹	菜品	汤羹	
浇汁娃娃菜	热菜	菜品	热菜	
浓情腊八粥	粥	主食	粥	
浓汤大白菜	热菜	菜品	热菜	
浓汤娃娃菜	热菜	菜品	热菜	
浓汤手打鱼腐娃娃菜	热菜	菜品	热菜	
浓汤番茄鸡蛋面	汤面	主食	面	汤面
浓汤鸡丝面	汤面	主食	面	汤面
浓汤鸡肉蘑菇面	汤面	主食	面	汤面
浓汤黑腐竹烧小白菜	热菜	菜品	热菜	
浓稠南瓜粥	粥	主食	粥	
浓稠黑米粥	粥	主食	粥	
浓香八宝粥	粥	主食	粥	
浓香小米粥	粥	主食	粥	
浓香番茄牛肉面	汤面	主食	面	汤面
浓香黑米粥	粥	主食	粥	
浓香黑米饭	白米饭	主食	饭	白米饭
海南鷄套餐配汤	其他饭	主食	饭	其他饭
海参参鸡汤	汤羹	菜品	汤羹	
海参小米粥	粥	主食	粥	
海参干鱿鱼粥	粥	主食	粥	
海参炒合菜	热菜	菜品	热菜	
海参猪肚粥	粥	主食	粥	
海参瘦肉粥	粥	主食	粥	
海参砂锅粥	粥	主食	粥	
海味杂锦粥	粥	主食	粥	
海味疙瘩汤	汤羹	菜品	汤羹	
海味裙带菜	凉菜	菜品	凉菜	
海城大拌菜	凉菜	菜品	凉菜	
海外小贡菜	凉菜	菜品	凉菜	
海宁菜炒肉丝	热菜	菜品	热菜	
海带丝炒百叶	热菜	菜品	热菜	
海带丝炒肉	热菜	菜品	热菜	
海带丝炒豆芽	热菜	菜品	热菜	
海带丝烧芹菜	热菜	菜品	热菜	
海带丝豆腐面	汤面	主食	面	汤面
海带同子骨汤	汤羹	菜品	汤羹	
海带土豆汤	汤羹	菜品	汤羹	
海带汤米饭	汤羹	菜品	汤羹	
海带炒土豆片	热菜	菜品	热菜	
海带炒肉丝	热菜	菜品	热菜	
海带炒豆芽	热菜	菜品	热菜	
海带炒黄豆	热菜	菜品	热菜	
海带炖冻豆腐	热菜	菜品	热菜	
海带炖土豆	热菜	菜品	热菜	
海带炖肉汤	汤羹	菜品	汤羹	
海带炖豆泡	热菜	菜品	热菜	
海带炖豆腐	热菜	菜品	热菜	
海带炖金针菇	热菜	菜品	热菜	
海带牛肉汤	汤羹	菜品	汤羹	
海带猪骨汤	汤羹	菜品	汤羹	
海带结海洋蔬菜	蔬菜类	火锅/串串/麻辣烫/色拉自选	配菜	蔬菜类
海带绿豆猪骨汤	汤羹	菜品	汤羹	
海带绿豆粥	粥	主食	粥	
海带老鸭汤	汤羹	菜品	汤羹	
海带肉丝面	汤面	主食	面	汤面
海带肉片汤	汤羹	菜品	汤羹	
海带脊骨汤	汤羹	菜品	汤羹	
海带豆腐味噌汤	汤羹	菜品	汤羹	
海带豆腐汤	汤羹	菜品	汤羹	
海带豆腐肉丝汤	汤羹	菜品	汤羹	
海带豆腐面	汤面	主食	面	汤面
海带青菜蛋汤	汤羹	菜品	汤羹	
海带骨头汤	汤羹	菜品	汤羹	
海带鸡蛋汤	汤羹	菜品	汤羹	
海带黄豆排骨汤	汤羹	菜品	汤羹	
海带黄豆龙骨汤	汤羹	菜品	汤羹	
海带龙骨玉米汤	汤羹	菜品	汤羹	
海帶炒豆芽	热菜	菜品	热菜	
海捕虾炖萝卜丝	热菜	菜品	热菜	
海捕黑头鱼炖豆腐一条	热菜	菜品	热菜	
海木耳蛋花汤	汤羹	菜品	汤羹	
海杂鱼炖土豆	热菜	菜品	热菜	
海生大拌菜	凉菜	菜品	凉菜	
海白冬瓜汤	汤羹	菜品	汤羹	
海砺豆腐汤	汤羹	菜品	汤羹	
海米冬瓜汤	汤羹	菜品	汤羹	
海米娃娃菜	凉菜	菜品	凉菜	
海米小白菜疙瘩汤	汤羹	菜品	汤羹	
海米拌芹菜	凉菜	菜品	凉菜	
海米炒油菜	热菜	菜品	热菜	
海米炒菜花	热菜	菜品	热菜	
海米炖冬瓜	热菜	菜品	热菜	
海米炖豆腐	热菜	菜品	热菜	
海米炝芹菜	热菜	菜品	热菜	
海米烧油菜	热菜	菜品	热菜	
海米白菜豆腐汤	汤羹	菜品	汤羹	
海米粉丝包菜	热菜	菜品	热菜	
海米菠菜粥	粥	主食	粥	
海米豆腐小白菜	热菜	菜品	热菜	
海苔香草鸡肉菌菇炖饭	烩饭	主食	饭	烩饭
海草裙带菜	凉菜	菜品	凉菜	
海菜嘎达汤	汤羹	菜品	汤羹	
海菜蛋花汤	汤羹	菜品	汤羹	
海菜豆腐蚬子汤	汤羹	菜品	汤羹	
海菜鱼丸汤	汤羹	菜品	汤羹	
海菜鸡蛋汤	汤羹	菜品	汤羹	
海虾炒白菜	热菜	菜品	热菜	
海虾黄鳝粥	粥	主食	粥	
海蚌豆腐汤	热菜	菜品	热菜	
海蛎子豆腐汤	汤羹	菜品	汤羹	
海蛎炒鸡蛋	热菜	菜品	热菜	
海蛎瘦肉粥	粥	主食	粥	
海蛎砂锅粥	粥	主食	粥	
海蛎肉炒蛋	热菜	菜品	热菜	
海蛎肉炒鸡蛋	热菜	菜品	热菜	
海蛎豆腐汤	汤羹	菜品	汤羹	
海蛎豆腐羹汤	汤羹	菜品	汤羹	
海边炖鲁子鱼	热菜	菜品	热菜	
海鱼炖豆腐	热菜	菜品	热菜	
海鲜一品粥	粥	主食	粥	
海鲜乌冬面	乌冬面	主食	面	乌冬面
海鲜全家福粥	粥	主食	粥	
海鲜冬瓜汤	汤羹	菜品	汤羹	
海鲜大白菜	热菜	菜品	热菜	
海鲜大白菜炖豆腐	热菜	菜品	热菜	
海鲜姜汤米面	汤面	主食	面	汤面
海鲜娃娃菜	热菜	菜品	热菜	
海鲜嫩豆腐汤	汤羹	菜品	汤羹	
海鲜小白菜	热菜	菜品	热菜	
海鲜小苔菜	热菜	菜品	热菜	
海鲜手工疙瘩汤	汤羹	菜品	汤羹	
海鲜杂烩粥	粥	主食	粥	
海鲜渔村小白菜	热菜	菜品	热菜	
海鲜炒小豆腐	热菜	菜品	热菜	
海鲜番茄意面	意大利面	主食	面	意大利面
海鲜番薯长寿面	汤面	主食	面	汤面
海鲜疙瘩汤	汤羹	菜品	汤羹	
海鲜砂锅粥	粥	主食	粥	
海鲜绿豆面	汤面	主食	面	汤面
海鲜芙蓉汤	汤羹	菜品	汤羹	
海鲜茭白饭	盖浇饭	主食	饭	盖浇饭
海鲜虾仁粥	粥	主食	粥	
海鲜蛋花疙瘩汤	汤羹	菜品	汤羹	
海鲜豆腐汤	汤羹	菜品	汤羹	
海鲜豆腐汤含米饭	其他菜品	其他	其他菜品	
海鲜豆腐汤米饭	泡饭	主食	饭	泡饭
海鲜豆腐脑汤	汤羹	菜品	汤羹	
海鲜长寿面	汤面	主食	面	汤面
海鲜青菜泡饭	泡饭	主食	饭	泡饭
海鲜鸡蛋面	汤面	主食	面	汤面
润燥雪梨银耳粥	粥	主食	粥	
淡味白米粥	粥	主食	粥	
淡菜贝壳汤	汤羹	菜品	汤羹	
淮山南瓜粥	粥	主食	粥	
淮山排骨砂锅粥	粥	主食	粥	
淮山排骨粥	粥	主食	粥	
淮山杞子炖本地鸡	热菜	菜品	热菜	
淮山杞子炖竹丝鸡	汤羹	菜品	汤羹	
淮山炒木耳	热菜	菜品	热菜	
淮山炒石耳	热菜	菜品	热菜	
淮山瘦肉粥	粥	主食	粥	
淮山百合炒虾仁	热菜	菜品	热菜	
淮山薏米炖排骨	汤羹	菜品	汤羹	
淮山薏米猪骨汤	汤羹	菜品	汤羹	
淮山薏米芡实粥	粥	主食	粥	
淮山银杏炒芥蓝	热菜	菜品	热菜	
淮扬头道菜	热菜	菜品	热菜	
淮扬炒软兜	热菜	菜品	热菜	
淮杞炖乌鸡汤	汤羹	菜品	汤羹	
淮杞炖竹丝鸡	汤羹	菜品	汤羹	
深海裙带菜	凉菜	菜品	凉菜	
深海鱼排饭	盖浇饭	主食	饭	盖浇饭
深海鱼片粥	粥	主食	粥	
深海鱼肚排骨粥	粥	主食	粥	
混合多种蔬菜底菜	健康餐	色拉轻食	健康餐	
混合蔬菜浓汤	汤羹	菜品	汤羹	
淸火绿豆粥	粥	主食	粥	
淸炒河虾仁	热菜	菜品	热菜	
清凉滋补老鸭汤	汤羹	菜品	汤羹	
清味时蔬粥	粥	主食	粥	
清新小拌菜	凉菜	菜品	凉菜	
清新玉米粥	粥	主食	粥	
清新绿豆粥	粥	主食	粥	
清晨的白粥	粥	主食	粥	
清水丸子汤	汤羹	菜品	汤羹	
清水烫蔬菜	热菜	菜品	热菜	
清水鱼加白菜	热菜	菜品	热菜	
清汆丸子汤	汤羹	菜品	汤羹	
清汤三鲜土豆粉刀削面	热菜	菜品	热菜	
清汤乌冬面	乌冬面	主食	面	乌冬面
清汤优质牛肉面	汤面	主食	面	汤面
清汤刀削面	汤面	主食	面	汤面
清汤加蒜叶香菜	汤羹	菜品	汤羹	
清汤打卤面	汤面	主食	面	汤面
清汤摊摊面	汤面	主食	面	汤面
清汤水潺面	汤面	主食	面	汤面
清汤热乌冬面	乌冬面	主食	面	乌冬面
清汤牛肉拉面	拉面	主食	面	拉面
清汤牛肉面	汤面	主食	面	汤面
清汤粉干加糟菜	米线	主食	粉	米线
清汤萝卜炖小排	热菜	菜品	热菜	
清汤萝卜炖牛腩	热菜	菜品	热菜	
清汤蔬菜面	汤面	主食	面	汤面
清汤豌杂面	汤面	主食	面	汤面
清汤豌豆刀削面	其他面	主食	面	其他面
清汤香菇包面	馄饨	主食	馄饨	
清汤骨头汤	汤羹	菜品	汤羹	
清汤鸡肉泡饭	泡饭	主食	饭	泡饭
清汤鸡肉面	汤面	主食	面	汤面
清汤鸡蛋拉面	拉面	主食	面	拉面
清汤鸡蛋面	汤面	主食	面	汤面
清润菜心粥	粥	主食	粥	
清淡白米粥	粥	主食	粥	
清淡紫菜蛋花汤	汤羹	菜品	汤羹	
清淡菠菜粥	粥	主食	粥	
清淡财鱼面	汤面	主食	面	汤面
清火养胃南瓜粥	粥	主食	粥	
清火慢炖白米粥	粥	主食	粥	
清火慢熬白粥	粥	主食	粥	
清火白米粥	粥	主食	粥	
清火白粥加小菜	粥	主食	粥	
清火绿豆粥	粥	主食	粥	
清火荷叶粥	粥	主食	粥	
清火香糯白米粥	粥	主食	粥	
清炒一品素珍	热菜	菜品	热菜	
清炒上海青	热菜	菜品	热菜	
清炒上海青菜	热菜	菜品	热菜	
清炒丝瓜尖	热菜	菜品	热菜	
清炒乌鱼片	热菜	菜品	热菜	
清炒五号白	热菜	菜品	热菜	
清炒五号菜	热菜	菜品	热菜	
清炒佛手瓜	热菜	菜品	热菜	
清炒八棱瓜	热菜	菜品	热菜	
清炒兰州莴苣	热菜	菜品	热菜	
清炒农场莴笋丝	其他菜品	其他	其他菜品	
清炒冬瓜片	热菜	菜品	热菜	
清炒凤尾菇	热菜	菜品	热菜	
清炒包心菜	热菜	菜品	热菜	
清炒包菜丝	热菜	菜品	热菜	
清炒华仔菇	热菜	菜品	热菜	
清炒南瓜丝	热菜	菜品	热菜	
清炒南瓜片	热菜	菜品	热菜	
清炒叶叶菜丨时令蔬菜	热菜	菜品	热菜	
清炒四季豆	热菜	菜品	热菜	
清炒四角豆	热菜	菜品	热菜	
清炒圆生菜	热菜	菜品	热菜	
清炒圆白菜	热菜	菜品	热菜	
清炒土豆丝	热菜	菜品	热菜	
清炒土豆丝不点汤不送	热菜	菜品	热菜	
清炒土豆丝不辣	热菜	菜品	热菜	
清炒土豆片	热菜	菜品	热菜	
清炒土黄瓜	热菜	菜品	热菜	
清炒地瓜叶	热菜	菜品	热菜	
清炒大白菜	热菜	菜品	热菜	
清炒大白菜云耳	热菜	菜品	热菜	
清炒大白菜秧子	热菜	菜品	热菜	
清炒大虾仁	热菜	菜品	热菜	
清炒娃娃菜	热菜	菜品	热菜	
清炒嫩缸豆	热菜	菜品	热菜	
清炒小南瓜	热菜	菜品	热菜	
清炒小油菜	热菜	菜品	热菜	
清炒小白莱	热菜	菜品	热菜	
清炒小白菜	热菜	菜品	热菜	
清炒小白菜盖饭	盖浇饭	主食	饭	盖浇饭
清炒小芹菜	热菜	菜品	热菜	
清炒小青菜	热菜	菜品	热菜	
清炒山药木耳	热菜	菜品	热菜	
清炒山药木耳莴笋	热菜	菜品	热菜	
清炒平包菜	热菜	菜品	热菜	
清炒广东菜心	热菜	菜品	热菜	
清炒广东西洋菜	热菜	菜品	热菜	
清炒新西兰甜豆	热菜	菜品	热菜	
清炒时令绿叶菜	热菜	菜品	热菜	
清炒时令菜	热菜	菜品	热菜	
清炒时令蔬	热菜	菜品	热菜	
清炒时令蔬菜	热菜	菜品	热菜	
清炒时蔬菜	热菜	菜品	热菜	
清炒有机花菜	热菜	菜品	热菜	
清炒本地豆芽	热菜	菜品	热菜	
清炒本地马蹄笋	热菜	菜品	热菜	
清炒杭白菜	热菜	菜品	热菜	
清炒楠溪江盘菜	热菜	菜品	热菜	
清炒毛毛菜	热菜	菜品	热菜	
清炒毛白菜	热菜	菜品	热菜	
清炒河虾仁	热菜	菜品	热菜	
清炒油菜盖饭	盖浇饭	主食	饭	盖浇饭
清炒油麦菜	热菜	菜品	热菜	
清炒油麦菜盖饭	盖浇饭	主食	饭	盖浇饭
清炒泰国虾仁	热菜	菜品	热菜	
清炒深海虾仁	热菜	菜品	热菜	
清炒炒冬瓜	热菜	菜品	热菜	
清炒玉米粒	热菜	菜品	热菜	
清炒甜豆米	热菜	菜品	热菜	
清炒生态西兰花	热菜	菜品	热菜	
清炒疙瘩丝	热菜	菜品	热菜	
清炒白玉翡翠	热菜	菜品	热菜	
清炒白菜木耳	热菜	菜品	热菜	
清炒白菜盖浇饭	盖浇饭	主食	饭	盖浇饭
清炒白菜秧	热菜	菜品	热菜	
清炒白菜苔	热菜	菜品	热菜	
清炒白菜苔小份	热菜	菜品	热菜	
清炒皇帝菜	热菜	菜品	热菜	
清炒空心菜	热菜	菜品	热菜	
清炒空运莴笋	热菜	菜品	热菜	
清炒窝笋丝	热菜	菜品	热菜	
清炒竹叶菜	热菜	菜品	热菜	
清炒笨豆芽	热菜	菜品	热菜	
清炒紫菜苔	热菜	菜品	热菜	
清炒红苋菜	热菜	菜品	热菜	
清炒红菜苔	热菜	菜品	热菜	
清炒红萝卜片	热菜	菜品	热菜	
清炒红薯叶	热菜	菜品	热菜	
清炒红薯尖	热菜	菜品	热菜	
清炒绿叶菜	热菜	菜品	热菜	
清炒绿豆芽	热菜	菜品	热菜	
清炒绿豆苗	热菜	菜品	热菜	
清炒肉丝面	盖浇面	主食	面	盖浇面
清炒胡萝卜丝	热菜	菜品	热菜	
清炒胡萝卜片	热菜	菜品	热菜	
清炒腰果虾仁	热菜	菜品	热菜	
清炒苦瓜丝	热菜	菜品	热菜	
清炒茴苣片	热菜	菜品	热菜	
清炒荷兰豆	热菜	菜品	热菜	
清炒荷兰豆盖饭	盖浇饭	主食	饭	盖浇饭
清炒莲子米	热菜	菜品	热菜	
清炒莴笋丝	热菜	菜品	热菜	
清炒莴笋叶	热菜	菜品	热菜	
清炒莴笋尖	热菜	菜品	热菜	
清炒莴笋干	热菜	菜品	热菜	
清炒莴笋木耳	热菜	菜品	热菜	
清炒莴笋片	热菜	菜品	热菜	
清炒莴笋片小碗菜	热菜	菜品	热菜	
清炒莴苣丝	热菜	菜品	热菜	
清炒莴苣叶	热菜	菜品	热菜	
清炒莴苣尖	热菜	菜品	热菜	
清炒莴苣片	热菜	菜品	热菜	
清炒菠菜盖饭	盖浇饭	主食	饭	盖浇饭
清炒萝卜丝	热菜	菜品	热菜	
清炒萝卜片	热菜	菜品	热菜	
清炒葫芦瓜	热菜	菜品	热菜	
清炒蒜泥西兰花	热菜	菜品	热菜	
清炒虾仁盖饭	盖浇饭	主食	饭	盖浇饭
清炒虾仁面	汤面	主食	面	汤面
清炒虾仁饭	盖浇饭	主食	饭	盖浇饭
清炒西兰花	热菜	菜品	热菜	
清炒西兰花木耳	热菜	菜品	热菜	
清炒西兰花盖饭	盖浇饭	主食	饭	盖浇饭
清炒西胡芦瓜	热菜	菜品	热菜	
清炒西葫芦	热菜	菜品	热菜	
清炒西蓝花	热菜	菜品	热菜	
清炒豆芽菜	热菜	菜品	热菜	
清炒豌豆尖	热菜	菜品	热菜	
清炒豌豆米	热菜	菜品	热菜	
清炒豌豆苗	热菜	菜品	热菜	
清炒酸豆角	热菜	菜品	热菜	
清炒铁棍山药	热菜	菜品	热菜	
清炒长豆角	热菜	菜品	热菜	
清炒青笋丝	热菜	菜品	热菜	
清炒青笋片	热菜	菜品	热菜	
清炒香乌笋	热菜	菜品	热菜	
清炒香菇小油菜	热菜	菜品	热菜	
清炒香菇菜	热菜	菜品	热菜	
清炒马兰头	热菜	菜品	热菜	
清炒高山菜	热菜	菜品	热菜	
清炒鱼豆腐	热菜	菜品	热菜	
清炒鲜百合	热菜	菜品	热菜	
清炒鲜芦笋	热菜	菜品	热菜	
清炒鸡毛菜	热菜	菜品	热菜	
清炒麻山药	热菜	菜品	热菜	
清炒黄瓜片	热菜	菜品	热菜	
清炒黄白菜	热菜	菜品	热菜	
清炒黄豆芽	热菜	菜品	热菜	
清炒黑木耳	热菜	菜品	热菜	
清炒龙须菜	热菜	菜品	热菜	
清炖乌鸡汤粉	米线	主食	粉	米线
清炖五宝鸡	热菜	菜品	热菜	
清炖土鸡半只	热菜	菜品	热菜	
清炖小黄鱼	热菜	菜品	热菜	
清炖排骨粥	粥	主食	粥	
清炖漠北羊汤	汤羹	菜品	汤羹	
清炖牛肉冬粉	其他粉	主食	粉	其他粉
清炖牛肉块汤	汤羹	菜品	汤羹	
清炖牛肉大碗	热菜	菜品	热菜	
清炖牛肉汤	汤羹	菜品	汤羹	
清炖牛肉面	汤面	主食	面	汤面
清炖牛肋条	热菜	菜品	热菜	
清炖玉米龙骨汤	汤羹	菜品	汤羹	
清炖老鸭汤	汤羹	菜品	汤羹	
清炖萝卜牛腩汤	汤羹	菜品	汤羹	
清炖豆腐汤	汤羹	菜品	汤羹	
清炖连藕汤	汤羹	菜品	汤羹	
清炖金寨土鹅半只	热菜	菜品	热菜	
清炖雪豆汤	糖水/炖品	甜点	糖水/炖品	
清炖鲫鱼汤	汤羹	菜品	汤羹	
清炖鲫鱼萝卜丝汤	汤羹	菜品	汤羹	
清炖鲫鱼豆腐汤	汤羹	菜品	汤羹	
清烧大白菜	热菜	菜品	热菜	
清爽海芥菜	凉菜	菜品	凉菜	
清爽绿豆粥	粥	主食	粥	
清爽荞麦冷面	凉面	主食	面	凉面
清爽蛋炒饭	炒饭	主食	饭	炒饭
清甜绿豆粥	粥	主食	粥	
清真酸汤小揪面	汤面	主食	面	汤面
清笋炒肉丝	热菜	菜品	热菜	
清肺菌类汤	汤羹	菜品	汤羹	
清脆裙带菜	浇头	菜品	浇头	
清蒸娃娃菜	蔬菜类	菜品	配菜	蔬菜类
清蒸带鱼饭	盖浇饭	主食	饭	盖浇饭
清蒸水蛋蒸菜	热菜	菜品	热菜	
清蒸瘦肉汤	汤羹	菜品	汤羹	
清蒸肉炖白菜豆腐	热菜	菜品	热菜	
清远鸡砂锅粥	粥	主食	粥	
清远鸡马蹄粥	粥	主食	粥	
清香原味小米粥	粥	主食	粥	
清香原味白粥	粥	主食	粥	
清香小米粥	粥	主食	粥	
清香油麦菜	蔬菜类	火锅/串串/麻辣烫/色拉自选	配菜	蔬菜类
清香浆水面	汤面	主食	面	汤面
清香白米饭	白米饭	主食	饭	白米饭
清香绿豆粥	粥	主食	粥	
清香草鸡汤	汤羹	菜品	汤羹	
清香荷叶粥	粥	主食	粥	
清香黄瓜咸菜	凉菜	菜品	凉菜	
渔家小白菜	热菜	菜品	热菜	
渔村小白菜	热菜	菜品	热菜	
渔村海鲜小白菜	热菜	菜品	热菜	
渔港大拌菜	凉菜	菜品	凉菜	
渣广椒炒土豆丝	热菜	菜品	热菜	
渣渣卷心菜	热菜	菜品	热菜	
渤海大虾熬白菜	热菜	菜品	热菜	
温县山药炒莴笋	热菜	菜品	热菜	
温州夹心鱼圆汤	汤羹	菜品	汤羹	
温州特色芥菜饭	盖浇饭	主食	饭	盖浇饭
温州特色鱼丸汤	汤羹	菜品	汤羹	
温州鱼丸汤	汤羹	菜品	汤羹	
温州鱼圆汤	汤羹	菜品	汤羹	
温州鱼面汤	汤面	主食	面	汤面
温泉蛋乌冬面	乌冬面	主食	面	乌冬面
温热南瓜汤	汤羹	菜品	汤羹	
温记府廟素豆汤	汤羹	菜品	汤羹	
温食全素荞麦面	健康餐	色拉轻食	健康餐	
港式甜品八宝豆沙粥	粥	主食	粥	
港式白灼生菜	热菜	菜品	热菜	
港式砂锅粥	粥	主食	粥	
港式素炒什锦	热菜	菜品	热菜	
游子老鸭粉丝汤	其他粉	主食	粉	其他粉
湖南炒丝瓜	热菜	菜品	热菜	
湖南生态大米煮的小煲饭	焖饭	主食	饭	焖饭
湘味小炒藕条	热菜	菜品	热菜	
湘味小炒香干	热菜	菜品	热菜	
湘味小青菜	热菜	菜品	热菜	
湘月阴米粥	粥	主食	粥	
湘炒土豆片	热菜	菜品	热菜	
湘西外婆菜	热菜	菜品	热菜	
湘西外婆菜小炒	盖浇饭	主食	饭	盖浇饭
湘西外婆菜炒蛋	热菜	菜品	热菜	
湘西外婆菜炒鸡蛋	热菜	菜品	热菜	
湘西炒菜花	热菜	菜品	热菜	
湛江白切鸡饭	盖浇饭	主食	饭	盖浇饭
溜豆腐盖饭	盖浇饭	主食	饭	盖浇饭
溜达鸡炖榛蘑半	热菜	菜品	热菜	
滋补乌鸡汤	汤羹	菜品	汤羹	
滋补乌鸡煨汤	汤羹	菜品	汤羹	
滋补乳鸽汤	汤羹	菜品	汤羹	
滋补养生小炒	热菜	菜品	热菜	
滋补养胃小米粥	粥	主食	粥	
滋补原味乌鸡汤	汤羹	菜品	汤羹	
滋补四红粥	粥	主食	粥	
滋补四黑粥	粥	主食	粥	
滋补山珍汤	汤羹	菜品	汤羹	
滋补山药粥	粥	主食	粥	
滋补竹荪鸡汤	汤羹	菜品	汤羹	
滋补老鸡炖松茸汤	汤羹	菜品	汤羹	
滋补野山菌汤	汤羹	菜品	汤羹	
滋补鲫鱼汤	汤羹	菜品	汤羹	
滋补鸽子汤	汤羹	菜品	汤羹	
滋补黑米粥	粥	主食	粥	
滑子菇炒肉	热菜	菜品	热菜	
滑子菇炒肉丝	热菜	菜品	热菜	
滑子蘑小白菜	热菜	菜品	热菜	
滑子蘑炒四素	热菜	菜品	热菜	
滑子蘑炒土豆丝	热菜	菜品	热菜	
滑子蘑炒小白菜	热菜	菜品	热菜	
滑子蘑炒粉中份	米线	主食	粉	米线
滑子蘑炒肉	热菜	菜品	热菜	
滑子蘑炒菜心	热菜	菜品	热菜	
滑炒素什锦	热菜	菜品	热菜	
滑炒黑鱼片	热菜	菜品	热菜	
滑蛋炒虾仁	热菜	菜品	热菜	
滑蛋炒蝦仁	热菜	菜品	热菜	
滑蛋牛肉粥	粥	主食	粥	
滑蛋牛肉鲜滚粥	粥	主食	粥	
滑蛋瘦肉粥	粥	主食	粥	
滑蛋肉丝粥	粥	主食	粥	
滑蛋虾仁炒青笋	热菜	菜品	热菜	
滑蛋虾仁盖饭	盖浇饭	主食	饭	盖浇饭
滑蛋虾仁粥	粥	主食	粥	
滑蛋虾仁饭	盖浇饭	主食	饭	盖浇饭
滑蛋青菜粥	粥	主食	粥	
滑蛋鱼片粥	粥	主食	粥	
满姐西红柿炒鸡蛋	热菜	菜品	热菜	
满朝黄金液粥	粥	主食	粥	
潘茄本鸡蛋炒虾仁	热菜	菜品	热菜	
潮州炒春菜	热菜	菜品	热菜	
潮州菜脯虾仁炒滑蛋	热菜	菜品	热菜	
潮府海鲜粥	粥	主食	粥	
潮式方鱼炒芥兰	热菜	菜品	热菜	
潮汕海鲜粥	粥	主食	粥	
潮汕牛丸汤	肉禽类	烧烤	肉禽类	
潮汕牛肉丸汤	汤羹	菜品	汤羹	
潮汕皮蛋瘦肉粥	粥	主食	粥	
潮汕粿条汤	其他粉	主食	粉	其他粉
潮汕红薯粥	粥	主食	粥	
潮汕西洋菜	蔬菜类	火锅/串串/麻辣烫/色拉自选	配菜	蔬菜类
潮汕鱼丸汤	汤羹	菜品	汤羹	
潮汕鸡蛋面	其他菜品	其他	其他菜品	
火烧夹素菜	火烧	主食	饼/囊/馍	火烧
火爆元白菜	热菜	菜品	热菜	
火爆圆白菜	热菜	菜品	热菜	
火爆大包菜	热菜	菜品	热菜	
火爆手撕包菜	热菜	菜品	热菜	
火爆有机蔬菜	热菜	菜品	热菜	
火爆甘蓝菜	热菜	菜品	热菜	
火腿有机蔬菜粥	粥	主食	粥	
火腿玉米粥	粥	主食	粥	
火腿玉米青菜粥	粥	主食	粥	
火腿瘦肉生菜粥	粥	主食	粥	
火腿瘦肉粥	粥	主食	粥	
火腿蔬菜粥	粥	主食	粥	
火腿青菜粥	粥	主食	粥	
火齐大地鱼炒芥兰	热菜	菜品	热菜	
火齐时令生菜	热菜	菜品	热菜	
火齐鲍鱼干贝虾粥	粥	主食	粥	
灰豆面加小菜	汤面	主食	面	汤面
灵芝乌鸡养生汤	汤羹	菜品	汤羹	
灵魂空心菜	浇头	其他	浇头	
灼意大利生菜	热菜	菜品	热菜	
炎记炒素粉	米线	主食	粉	米线
炒什锦菌菇	热菜	菜品	热菜	
炒什锦蔬菜	热菜	菜品	热菜	
炒什锦蘑菇	热菜	菜品	热菜	
炒出来的土豆泥	热菜	菜品	热菜	
炒千叶豆腐	热菜	菜品	热菜	
炒千页豆腐	热菜	菜品	热菜	
炒卜留克丝	热菜	菜品	热菜	
炒卤拉丝豆腐	热菜	菜品	热菜	
炒合菜大份	热菜	菜品	热菜	
炒合菜小份	热菜	菜品	热菜	
炒合菜小小份	热菜	菜品	热菜	
炒圆白菜盖浇饭	盖浇饭	主食	饭	盖浇饭
炒土豆丝不辣	热菜	菜品	热菜	
炒土豆丝半分	热菜	菜品	热菜	
炒土豆丝盖浇饭	盖浇饭	主食	饭	盖浇饭
炒土豆片半份	热菜	菜品	热菜	
炒土豆鸡丝	热菜	菜品	热菜	
炒大头菜三丝	热菜	菜品	热菜	
炒大头菜丝干豆腐	热菜	菜品	热菜	
炒大碗花菜	热菜	菜品	热菜	
炒季节时蔬	热菜	菜品	热菜	
炒安溪豆干	热菜	菜品	热菜	
炒小瓜木耳	热菜	菜品	热菜	
炒小白菜肉丝粉条	热菜	菜品	热菜	
炒小青菜秧	热菜	菜品	热菜	
炒小黄豆芽	热菜	菜品	热菜	
炒尖椒干豆腐	热菜	菜品	热菜	
炒山药丸子	热菜	菜品	热菜	
炒山药傀儡	热菜	菜品	热菜	
炒山药半份	热菜	菜品	热菜	
炒山药小份	热菜	菜品	热菜	
炒山药彩椒木耳	热菜	菜品	热菜	
炒山药芥芥	热菜	菜品	热菜	
炒山里白粿	热菜	菜品	热菜	
炒干豆腐半盘	热菜	菜品	热菜	
炒平阳粉丝加蛋	热菜	菜品	热菜	
炒时令蔬菜	热菜	菜品	热菜	
炒时蔬便当	其他饭	主食	饭	其他饭
炒时蔬油麦菜	热菜	菜品	热菜	
炒昭通小土豆	热菜	菜品	热菜	
炒有机花菜	热菜	菜品	热菜	
炒有机菜花	热菜	菜品	热菜	
炒有机菜花木耳	热菜	菜品	热菜	
炒杂菜盖饭	盖浇饭	主食	饭	盖浇饭
炒杂菜粉丝套餐	其他菜品	其他	其他菜品	
炒杂陈粉丝	热菜	菜品	热菜	
炒杏鲍菇丝	热菜	菜品	热菜	
炒油菜一份	热菜	菜品	热菜	
炒洋丝瓜尖	热菜	菜品	热菜	
炒洋芋擦擦	热菜	菜品	热菜	
炒洋芋津津	热菜	菜品	热菜	
炒洋芋米皮	凉皮	主食	凉皮	
炒海带豆芽	热菜	菜品	热菜	
炒湖南白丝瓜	热菜	菜品	热菜	
炒炒奶白菜	热菜	菜品	热菜	
炒玉米半份	热菜	菜品	热菜	
炒甜脆玉米	热菜	菜品	热菜	
炒盖菜虾米	热菜	菜品	热菜	
炒绿豆粉丝	其他粉	主食	粉	其他粉
炒绿豆芽菜	热菜	菜品	热菜	
炒肉末酸豆角	热菜	菜品	热菜	
炒肉芥菜丝	热菜	菜品	热菜	
炒胡萝卜丝	热菜	菜品	热菜	
炒自家豆芽	热菜	菜品	热菜	
炒花菜小份	热菜	菜品	热菜	
炒芹菜豆芽	热菜	菜品	热菜	
炒芹菜豆芽肉	热菜	菜品	热菜	
炒茄丝微辣	热菜	菜品	热菜	
炒茄子尖椒	热菜	菜品	热菜	
炒茄子菜豆	热菜	菜品	热菜	
炒荞面叶叶	炒面	主食	面	炒面
炒莜面块垒	炒面	主食	面	炒面
炒莜面芋子	炒面	主食	面	炒面
炒葱香干豆腐丝	凉菜	菜品	凉菜	
炒蒜苔小份	热菜	菜品	热菜	
炒蘑菇土豆片	热菜	菜品	热菜	
炒虾皮青椒	热菜	菜品	热菜	
炒西红柿鸡蛋刀削面	其他面	主食	面	其他面
炒西葫芦肉丝	热菜	菜品	热菜	
炒豆米小份	热菜	菜品	热菜	
炒豆腐干丁	热菜	菜品	热菜	
炒豆芽一份	热菜	菜品	热菜	
炒豆芽半盘	热菜	菜品	热菜	
炒酸萝卜丝	热菜	菜品	热菜	
炒酸黄瓜丝	热菜	菜品	热菜	
炒铁杆山药	热菜	菜品	热菜	
炒青菜小份	热菜	菜品	热菜	
炒面加西红柿	炒面	主食	面	炒面
炒韮菜绿豆芽	热菜	菜品	热菜	
炒饭不加小葱	热菜	菜品	热菜	
炒饭中加洋葱	炒饭	主食	饭	炒饭
炒饭里加平菇	浇头	其他	浇头	
炖卤水豆腐	热菜	菜品	热菜	
炖小黄花鱼	热菜	菜品	热菜	
炖海带土豆丝	热菜	菜品	热菜	
炖清汤丸子	汤羹	菜品	汤羹	
炖牛肉丸子	热菜	菜品	热菜	
炖牛肉大份	热菜	菜品	热菜	
炖牛肉套餐	其他菜品	其他	其他菜品	
炖牛肉烩白菜	热菜	菜品	热菜	
炖牛肉长豆角烧紫茄双拼套餐	其他菜品	其他	其他菜品	
炖白菜豆付粉条	热菜	菜品	热菜	
炖罐乌鸡汤	汤羹	菜品	汤羹	
炖肉白菜粉条小份	热菜	菜品	热菜	
炖芸豆土豆	热菜	菜品	热菜	
炖菠菜粉条	热菜	菜品	热菜	
炖藕汤十蘸水	汤羹	菜品	汤羹	
炖豆腐粉条白菜加肉	热菜	菜品	热菜	
炖酸菜小份	热菜	菜品	热菜	
炖酸萝卜丝	热菜	菜品	热菜	
炖鱼头泡饼	热菜	菜品	热菜	
炖鸡清汤米粉	米线	主食	粉	米线
炖黄山笋衣	热菜	菜品	热菜	
炝拌圆白菜	凉菜	菜品	凉菜	
炝拌土豆丝小份菜	凉菜	菜品	凉菜	
炝拌小白菜	凉菜	菜品	凉菜	
炝拌山野菜	凉菜	菜品	凉菜	
炝拌灰灰菜	凉菜	菜品	凉菜	
炝拌牛心菜	凉菜	菜品	凉菜	
炝拌甘蓝菜	凉菜	菜品	凉菜	
炝拌苜蓿菜	凉菜	菜品	凉菜	
炝拌荠荠菜	凉菜	菜品	凉菜	
炝拌鸡毛菜	凉菜	菜品	凉菜	
炝汁西生菜	凉菜	菜品	凉菜	
炝炒上海青	热菜	菜品	热菜	
炝炒包心菜	热菜	菜品	热菜	
炝炒包菜丝	热菜	菜品	热菜	
炝炒卷心菜	热菜	菜品	热菜	
炝炒圆白菜	热菜	菜品	热菜	
炝炒圆白菜盖饭	盖浇饭	主食	饭	盖浇饭
炝炒圆白菜粉丝	热菜	菜品	热菜	
炝炒土豆丝	热菜	菜品	热菜	
炝炒奶白菜	热菜	菜品	热菜	
炝炒娃娃菜	热菜	菜品	热菜	
炝炒孜然菠菜	热菜	菜品	热菜	
炝炒小油菜	热菜	菜品	热菜	
炝炒小白菜	热菜	菜品	热菜	
炝炒手撕包菜	热菜	菜品	热菜	
炝炒手撕菜	热菜	菜品	热菜	
炝炒有机菜花	热菜	菜品	热菜	
炝炒毛白菜	热菜	菜品	热菜	
炝炒油麦菜	热菜	菜品	热菜	
炝炒牛心菜	蔬菜类	菜品	配菜	蔬菜类
炝炒白豆子	热菜	菜品	热菜	
炝炒空心菜	热菜	菜品	热菜	
炝炒红苕尖	热菜	菜品	热菜	
炝炒红薯尖	热菜	菜品	热菜	
炝炒绿豆芽	热菜	菜品	热菜	
炝炒花菜小份	热菜	菜品	热菜	
炝炒花菜小碗菜	热菜	菜品	热菜	
炝炒莲白丨小明白	热菜	菜品	热菜	
炝炒莲花白	热菜	菜品	热菜	
炝炒莴笋尖	热菜	菜品	热菜	
炝炒莴苣丝	热菜	菜品	热菜	
炝炒西兰花	热菜	菜品	热菜	
炝炒西生菜	热菜	菜品	热菜	
炝炒西葫芦	热菜	菜品	热菜	
炝炒豆皮丝	热菜	菜品	热菜	
炝炒连花白	热菜	菜品	热菜	
炝炒雪里红	热菜	菜品	热菜	
炝炒青油菜	热菜	菜品	热菜	
炝炒鲜红薯叶	热菜	菜品	热菜	
炝炒黄豆芽	热菜	菜品	热菜	
炝炒黄豆芽小份	热菜	菜品	热菜	
炝锅疙瘩汤	汤羹	菜品	汤羹	
炝锅龙须面	汤面	主食	面	汤面
炭烤娃娃菜	蔬菜类	烧烤	蔬菜类	
炭烤小青菜	蔬菜类	烧烤	蔬菜类	
炭烧粉丝娃娃菜	热菜	菜品	热菜	
炸豆腐鲜汤	汤羹	菜品	汤羹	
点爆娃娃菜	蔬菜类	火锅/串串/麻辣烫/色拉自选	配菜	蔬菜类
点菜请点米饭	白米饭	主食	饭	白米饭
点菜需点米饭	白米饭	主食	饭	白米饭
点餐请点米饭	白米饭	主食	饭	白米饭
烂糊肉丝十米饭	其他菜品	其他	其他菜品	
烂肉炒茄子	热菜	菜品	热菜	
烤乡里花菜	蔬菜类	烧烤	蔬菜类	
烤农家小青菜	蔬菜类	烧烤	蔬菜类	
烤有机花菜	热菜	菜品	热菜	
烤蘑菇炒菠菜	热菜	菜品	热菜	
烤豆腐卷韭菜	蔬菜类	烧烤	蔬菜类	
烤豆腐皮卷生菜	蔬菜类	烧烤	蔬菜类	
烤锡纸娃娃菜	蔬菜类	烧烤	蔬菜类	
烤鱼伴侣娃娃菜	浇头	其他	浇头	
烧三丝小份菜	热菜	菜品	热菜	
烧全素盖饭	盖浇饭	主食	饭	盖浇饭
烧椒炒鸡蛋	热菜	菜品	热菜	
烧羊肉白菜	热菜	菜品	热菜	
烧茄子十米饭	其他菜品	其他	其他菜品	
烧茄子十醋溜木须十两份米饭	热菜	菜品	热菜	
烧茄子小份菜	热菜	菜品	热菜	
烧茄子小份菜不带米饭	热菜	菜品	热菜	
烧茄子炒菜	热菜	菜品	热菜	
烧茄子盖浇饭	盖浇饭	主食	饭	盖浇饭
烧茄子盖烧饭	盖浇饭	主食	饭	盖浇饭
烧茄子盖饭	盖浇饭	主食	饭	盖浇饭
烧茄子盘饭	盖浇饭	主食	饭	盖浇饭
烧蒸娃娃菜	热菜	菜品	热菜	
烧豆腐盖饭	盖浇饭	主食	饭	盖浇饭
烧饼夹杭椒炒鸡蛋	夹饼/夹馍	主食	饼/囊/馍	夹饼/夹馍
烧饼夹炒洋葱	夹饼/夹馍	主食	饼/囊/馍	夹饼/夹馍
烧饼夹炒豆腐干	夹饼/夹馍	主食	饼/囊/馍	夹饼/夹馍
烧饼夹青椒炒干豆皮	夹饼/夹馍	主食	饼/囊/馍	夹饼/夹馍
烩乌鱼蛋汤	汤羹	菜品	汤羹	
烫菜娃娃菜	蔬菜类	火锅/串串/麻辣烫/色拉自选	配菜	蔬菜类
烫豆腐皮青菜	热菜	菜品	热菜	
烫高山娃娃菜	热菜	菜品	热菜	
热乎的五常大米饭	白米饭	主食	饭	白米饭
热卖丨美味可口丨香菇鸡肉粥	粥	主食	粥	
热卤黄花菜	热菜	菜品	热菜	
热姜薯片雪耳红枣汤	糖水/炖品	甜点	糖水/炖品	
热拌青椒干丝面	拌面	主食	面	拌面
热木瓜银耳汤	其他甜品	甜点	其他甜品	
热桂圆红枣汤	糖水/炖品	甜点	糖水/炖品	
热汤玉米面	汤面	主食	面	汤面
热汤荞麦面	汤面	主食	面	汤面
热炒素什锦	热菜	菜品	热菜	
热甜八宝粥	粥	主食	粥	
热红豆米仁汤	糖水/炖品	甜点	糖水/炖品	
热销丨皮蛋瘦肉粥	粥	主食	粥	
热销皮蛋瘦肉粥	粥	主食	粥	
焖炖猪软骨蔬菜菌菇汤面	汤面	主食	面	汤面
煎或炒豆干	热菜	菜品	热菜	
煎炒四季豆	热菜	菜品	热菜	
煎饼加六种青菜	其他主食	主食	其他主食	
煸炒四季豆	热菜	菜品	热菜	
熊猫笋香面	汤面	主食	面	汤面
熟地乌豆汤	汤羹	菜品	汤羹	
熟地黑豆汤	汤羹	菜品	汤羹	
熟萝卜炖黄豆	热菜	菜品	热菜	
燊记疙瘩汤	汤羹	菜品	汤羹	
燕鲅鱼炖土豆	热菜	菜品	热菜	
燕麦八宝养胃粥	粥	主食	粥	
燕麦冬梨粥	粥	主食	粥	
燕麦南瓜小米粥	粥	主食	粥	
燕麦南瓜粥	粥	主食	粥	
燕麦小米粥	粥	主食	粥	
燕麦椰奶粥	粥	主食	粥	
燕麦牛奶粥	粥	主食	粥	
燕麦生菜粥	粥	主食	粥	
燕麦红枣红糖粥	粥	主食	粥	
燕麦绿豆粥	粥	主食	粥	
燕麦薏仁粥	粥	主食	粥	
燕麦雪梨粥	粥	主食	粥	
燕麦青菜粥	粥	主食	粥	
爆炒千页豆腐	热菜	菜品	热菜	
爆炒卷心菜	热菜	菜品	热菜	
爆炒圆白菜	热菜	菜品	热菜	
爆炒圆白菜米饭	其他菜品	其他	其他菜品	
爆炒娃娃菜	热菜	菜品	热菜	
爆炒小虾黄豆芽	热菜	菜品	热菜	
爆炒手撕包菜	热菜	菜品	热菜	
爆炒有机菜花	热菜	菜品	热菜	
爆炒杏鲍菇	热菜	菜品	热菜	
爆炒油麦菜	热菜	菜品	热菜	
爆炒洋白菜	热菜	菜品	热菜	
爆炒甘兰菜加鸡蛋	热菜	菜品	热菜	
爆炒白玉菇	热菜	菜品	热菜	
爆炒笨豆芽	热菜	菜品	热菜	
爆炒绿豆芽	热菜	菜品	热菜	
爆炒胡萝卜丝	热菜	菜品	热菜	
爆炒西葫芦	热菜	菜品	热菜	
爆炒酸菜豆腐皮	热菜	菜品	热菜	
爆炒香菇小油菜	热菜	菜品	热菜	
爆炒黄豆芽	热菜	菜品	热菜	
爆赞八宝粥	粥	主食	粥	
爱品尚老鸭粉丝汤	其他粉	主食	粉	其他粉
爱心南瓜粥	粥	主食	粥	
爱心小米粥	粥	主食	粥	
爱心玉米面粥	粥	主食	粥	
爽口什锦小菜	凉菜	菜品	凉菜	
爽口卷心菜	热菜	菜品	热菜	
爽口四丁菜	热菜	菜品	热菜	
爽口圆生菜	蔬菜类	火锅/串串/麻辣烫/色拉自选	配菜	蔬菜类
爽口大头菜	凉菜	菜品	凉菜	
爽口大拌菜	凉菜	菜品	凉菜	
爽口娃娃菜	蔬菜类	菜品	蔬菜类	
爽口小泡菜	凉菜	菜品	凉菜	
爽口小炒银芽	热菜	菜品	热菜	
爽口小菜多味裙带菜	凉菜	菜品	凉菜	
爽口时蔬大拌菜	凉菜	菜品	凉菜	
爽口木耳菜	凉菜	菜品	凉菜	
爽口油淋娃娃菜	热菜	菜品	热菜	
爽口海白菜	凉菜	菜品	凉菜	
爽口海草小菜	凉菜	菜品	凉菜	
爽口海藻菜	凉菜	菜品	凉菜	
爽口绿豆粥	粥	主食	粥	
爽口菜心苗小碗菜	热菜	菜品	热菜	
爽口萝卜小配菜	凉菜	菜品	凉菜	
爽口裙带菜	凉菜	菜品	凉菜	
爽口龙须菜	凉菜	菜品	凉菜	
爽囗小米粥	粥	主食	粥	
爽滑牛肉粥	粥	主食	粥	
爽滑肉片粥	粥	主食	粥	
爽脆卤花菜	凉菜	菜品	凉菜	
爽脆猪肚粥	粥	主食	粥	
爽脆裙带菜	凉菜	菜品	凉菜	
片片青菜粥	粥	主食	粥	
牛丸萝卜汤	汤羹	菜品	汤羹	
牛奶南瓜粥	粥	主食	粥	
牛奶可可八宝粥	粥	主食	粥	
牛奶小米粥	粥	主食	粥	
牛奶木瓜炖雪燕	其他甜品	甜点	其他甜品	
牛奶燕麦粥	粥	主食	粥	
牛奶紫薯燕麦粥	粥	主食	粥	
牛奶红豆粥	粥	主食	粥	
牛奶蒸有机米饭	白米饭	主食	饭	白米饭
牛奶蛋花汤	汤羹	菜品	汤羹	
牛奶金瓜燕麦粥	粥	主食	粥	
牛奶香米粥	粥	主食	粥	
牛奶香蕉燕麦粥	粥	主食	粥	
牛奶麦片粥	粥	主食	粥	
牛奶黑米麦片粥	粥	主食	粥	
牛尾巴炖白萝卜	热菜	菜品	热菜	
牛尾黑豆汤	汤羹	菜品	汤羹	
牛排烤蔬菜薏仁糙米藜麦饭	健康餐	色拉轻食	健康餐	
牛杂碎炖萝卜	热菜	菜品	热菜	
牛杂萝卜汤	汤羹	菜品	汤羹	
牛柳炒茭白	热菜	菜品	热菜	
牛棒骨汤炖白菜豆腐	热菜	菜品	热菜	
牛瘦肉汤饭	泡饭	主食	饭	泡饭
牛眼贝炖小白菜	热菜	菜品	热菜	
牛筋面加玉米面	其他面	主食	面	其他面
牛筋面玉米面	其他面	主食	面	其他面
牛肉丝炒笋丝	热菜	菜品	热菜	
牛肉丝炒豆芽	其他小吃	小吃	其他小吃	
牛肉丸生菜汤	汤羹	菜品	汤羹	
牛肉丸萝卜粉丝汤	其他粉	主食	粉	其他粉
牛肉乌冬面	乌冬面	主食	面	乌冬面
牛肉什蔬胚芽米粥	粥	主食	粥	
牛肉千张汤	汤羹	菜品	汤羹	
牛肉卷贡菜	肉禽类	火锅/串串/麻辣烫/色拉自选	配菜	肉禽类
牛肉土豆丝饭	盖浇饭	主食	饭	盖浇饭
牛肉土豆饭	盖浇饭	主食	饭	盖浇饭
牛肉大白菜粉丝饭	盖浇饭	主食	饭	盖浇饭
牛肉大米山药粥	粥	主食	粥	
牛肉大葱饼送粥	馅饼	主食	饼/囊/馍	馅饼
牛肉山粉面	汤面	主食	面	汤面
牛肉山药粥	粥	主食	粥	
牛肉当归粥	粥	主食	粥	
牛肉手擀汤面	手擀面	主食	面	手擀面
牛肉时蔬粥	粥	主食	粥	
牛肉杂菌营养汤面	汤面	主食	面	汤面
牛肉汤套餐十豆腐十青菜十饭	其他菜品	其他	其他菜品	
牛肉汤炖千张小份	热菜	菜品	热菜	
牛肉汤炖萝卜	热菜	菜品	热菜	
牛肉波菜粥	粥	主食	粥	
牛肉洋芋稀饭	粥	主食	粥	
牛肉海带汤	汤羹	菜品	汤羹	
牛肉清汤面	汤面	主食	面	汤面
牛肉炒杂菜	热菜	菜品	热菜	
牛肉炒芥兰	热菜	菜品	热菜	
牛肉炒芹菜	热菜	菜品	热菜	
牛肉炒茭白随机	热菜	菜品	热菜	
牛肉炒菜心	热菜	菜品	热菜	
牛肉炒萝卜	热菜	菜品	热菜	
牛肉炒豆芽	热菜	菜品	热菜	
牛肉炒青菜	热菜	菜品	热菜	
牛肉炒魔芋丝饭套餐	盖浇饭	主食	饭	盖浇饭
牛肉炖土豆	热菜	菜品	热菜	
牛肉炖木耳	热菜	菜品	热菜	
牛肉炖番茄	热菜	菜品	热菜	
牛肉炖白菜干豆腐	热菜	菜品	热菜	
牛肉炖老豆腐	热菜	菜品	热菜	
牛肉炖萝卜	热菜	菜品	热菜	
牛肉炖萝卜半份	热菜	菜品	热菜	
牛肉炖萝卜汤	汤羹	菜品	汤羹	
牛肉炖萝卜送米饭小菜	其他菜品	其他	其他菜品	
牛肉炖西红柿	热菜	菜品	热菜	
牛肉炖西红柿土豆	热菜	菜品	热菜	
牛肉炖西红柿套餐	其他菜品	其他	其他菜品	
牛肉炖豆腐送米饭小菜	其他菜品	其他	其他菜品	
牛肉炖酸菜大份	热菜	菜品	热菜	
牛肉炖黄花菜	热菜	菜品	热菜	
牛肉烧白菜	热菜	菜品	热菜	
牛肉片炒青椒	热菜	菜品	热菜	
牛肉牛肚烧白菜	热菜	菜品	热菜	
牛肉番茄汤	汤羹	菜品	汤羹	
牛肉番茄炒粄	米线	主食	粉	米线
牛肉白菜炖粉条	热菜	菜品	热菜	
牛肉砂锅粥	粥	主食	粥	
牛肉粉丝千张汤	其他粉	主食	粉	其他粉
牛肉粉丝汤米饭	其他粉	主食	粉	其他粉
牛肉粉丝青菜汤	汤羹	菜品	汤羹	
牛肉胡萝卜烩饭	烩饭	主食	饭	烩饭
牛肉胡萝卜粥	粥	主食	粥	
牛肉腐竹蔬菜面	拌面	主食	面	拌面
牛肉茴香饼送玉米粥	其他菜品	其他	其他菜品	
牛肉荞麦面	汤面	主食	面	汤面
牛肉萝卜汤	汤羹	菜品	汤羹	
牛肉萝卜粥	粥	主食	粥	
牛肉蒿子面	盖浇面	主食	面	盖浇面
牛肉蔬菜粥	粥	主食	粥	
牛肉蔬菜营养面	汤面	主食	面	汤面
牛肉蘑菇汤	汤羹	菜品	汤羹	
牛肉蛋花粥	粥	主食	粥	
牛肉豆皮汤	汤羹	菜品	汤羹	
牛肉豆腐汤	汤羹	菜品	汤羹	
牛肉豆腐汤自带一碗米饭	其他菜品	其他	其他菜品	
牛肉豆腐面	盖浇面	主食	面	盖浇面
牛肉豌豆面	汤面	主食	面	汤面
牛肉青菜粉丝汤	其他粉	主食	粉	其他粉
牛肉青菜粥	粥	主食	粥	
牛肉鸡汤番茄荞麦面	汤面	主食	面	汤面
牛腩炖老豆腐	热菜	菜品	热菜	
牛腩炖西红柿	热菜	菜品	热菜	
牛腩筋炖萝卜	热菜	菜品	热菜	
牛腩萝卜饭	其他饭	主食	饭	其他饭
牛骨头海带汤	热菜	菜品	热菜	
牛骨头清汤	汤羹	菜品	汤羹	
牧山村大拌菜	凉菜	菜品	凉菜	
牧民大拌菜	凉菜	菜品	凉菜	
特产海芹菜	凉菜	菜品	凉菜	
特价心意南瓜粥	粥	主食	粥	
特价杂粮粥	粥	主食	粥	
特价洋白菜炒粉条	热菜	菜品	热菜	
特价西红柿炒鸡蛋	热菜	菜品	热菜	
特价香菇油菜	热菜	菜品	热菜	
特制猪骨乌冬面	乌冬面	主食	面	乌冬面
特制骨汤蔬菜乌冬面	乌冬面	主食	面	乌冬面
特惠大米粥	粥	主食	粥	
特惠尖椒炒鸡蛋	热菜	菜品	热菜	
特惠鸡肉炖土豆	热菜	菜品	热菜	
特级白米粥	粥	主食	粥	
特级黄花菜	蔬菜类	火锅/串串/麻辣烫/色拉自选	配菜	蔬菜类
特色三鲜面	汤面	主食	面	汤面
特色东北酸菜	凉菜	菜品	凉菜	
特色乌米饭	其他饭	主食	饭	其他饭
特色二米饭	白米饭	主食	饭	白米饭
特色五常米饭	白米饭	主食	饭	白米饭
特色八宝粥	粥	主食	粥	
特色包菜饭	盖浇饭	主食	饭	盖浇饭
特色南瓜粥	粥	主食	粥	
特色呛白菜	热菜	菜品	热菜	
特色大碴粥	粥	主食	粥	
特色姜汁猪肚面	盖浇面	主食	面	盖浇面
特色姜汤面	汤面	主食	面	汤面
特色家常麦面	汤面	主食	面	汤面
特色小楂粥	粥	主食	粥	
特色小炒藕	热菜	菜品	热菜	
特色小米粥	粥	主食	粥	
特色手工面	手擀面	主食	面	手擀面
特色手撕包菜	热菜	菜品	热菜	
特色打卤面	盖浇面	主食	面	盖浇面
特色拌莜面	其他面	主食	面	其他面
特色海鲜粥	粥	主食	粥	
特色清汤荞麦热面	凉面	主食	面	凉面
特色游子老鸭粉丝汤	其他粉	主食	粉	其他粉
特色炒合菜	热菜	菜品	热菜	
特色炒白菜	热菜	菜品	热菜	
特色炒腐竹	热菜	菜品	热菜	
特色炒茄丁	热菜	菜品	热菜	
特色牛肉粥	粥	主食	粥	
特色玉米面	其他菜品	其他	其他菜品	
特色疙瘩汤	汤羹	菜品	面	其他面
特色白米饭	白米饭	主食	饭	白米饭
特色白菜炖豆腐	热菜	菜品	热菜	
特色石板卷心菜	热菜	菜品	热菜	
特色紫米饭	焖饭	主食	饭	焖饭
特色绿豆圆汤	汤羹	菜品	汤羹	
特色绿豆粥	粥	主食	粥	
特色老汤面	汤面	主食	面	汤面
特色老鸭粉丝汤	其他粉	主食	粉	其他粉
特色荞麦冷面	凉面	主食	面	凉面
特色荷叶粥	粥	主食	粥	
特色菜脯粥	粥	主食	粥	
特色萝卜菜蛋炒饭	炒饭	主食	饭	炒饭
特色营养沙汤	汤羹	菜品	汤羹	
特色豆泡汤	汤羹	菜品	汤羹	
特色豆腐炒年糕	年糕	主食	年糕	
特色豆腐面	汤面	主食	面	汤面
特色豆面粥	粥	主食	粥	
特色豌豆面	汤面	主食	面	汤面
特色酸菜汤	热菜	菜品	热菜	
特色鱼丸汤	汤羹	菜品	汤羹	
特色鸡汤面	汤面	主食	面	汤面
犟香茄子饭	其他菜品	其他	其他菜品	
状元及第粥	粥	主食	粥	
状元鸿皮蛋瘦肉粥	粥	主食	粥	
独特番茄打卤面	盖浇面	主食	面	盖浇面
狮子头炖白菜	热菜	菜品	热菜	
狮子头炖豆腐	热菜	菜品	热菜	
狮子头素浇饭	盖浇饭	主食	饭	盖浇饭
狮子头豆腐小白菜	热菜	菜品	热菜	
狮子头青菜	热菜	菜品	热菜	
狮子头青菜土豆丝盖饭	盖浇饭	主食	饭	盖浇饭
猪杂枸杞汤	汤羹	菜品	汤羹	
猪皮炒芹菜	热菜	菜品	热菜	
猪省瘦肉粥	粥	主食	粥	
猪肉丸子冬瓜汤	汤羹	菜品	汤羹	
猪肉丸枸杞叶汤	汤羹	菜品	汤羹	
猪肉大白菜	饺子	主食	饺子	
猪肉小白菜	饺子	主食	饺子	
猪肉汆白丸子汤	汤羹	菜品	汤羹	
猪肉炖大白菜粉丝	热菜	菜品	热菜	
猪肉炖白菜粉条	热菜	菜品	热菜	
猪肉炖白菜豆腐	热菜	菜品	热菜	
猪肉炖粉条白菜	热菜	菜品	热菜	
猪肉炖豆腐	热菜	菜品	热菜	
猪肉炖豆角	热菜	菜品	热菜	
猪肉玉米胚芽米粥	粥	主食	粥	
猪肉白菜炖	热菜	菜品	热菜	
猪肉白菜炖粉条	热菜	菜品	热菜	
猪肉豆腐白菜	热菜	菜品	热菜	
猪肉酸菜汤	汤羹	菜品	汤羹	
猪肉青菜粥	粥	主食	粥	
猪肉青萝卜手打丸子汤	汤羹	菜品	汤羹	
猪肚冬瓜汤	汤羹	菜品	汤羹	
猪肚汤套餐饭	其他饭	主食	饭	其他饭
猪肚炖老菜脯	汤羹	菜品	汤羹	
猪肚炖莲子	汤羹	菜品	汤羹	
猪肚砂锅粥	粥	主食	粥	
猪肚红枣粥	粥	主食	粥	
猪肚莲子砂锅粥	粥	主食	粥	
猪肚莲子粥	粥	主食	粥	
猪肚骨头砂锅粥	粥	主食	粥	
猪肚鲜虾粥	粥	主食	粥	
猪肚黑萝卜汤	汤羹	菜品	汤羹	
猪肝枸杞玉米粥	粥	主食	粥	
猪肝瘦肉枸杞汤	汤羹	菜品	汤羹	
猪肝瘦肉粥	粥	主食	粥	
猪肝菠菜粥	粥	主食	粥	
猪肝青菜明目粥	粥	主食	粥	
猪肝青菜粥	粥	主食	粥	
猪血大白菜	热菜	菜品	热菜	
猪血炒雪菜	热菜	菜品	热菜	
猪血炒韭菜	热菜	菜品	热菜	
猪血炖豆腐	热菜	菜品	热菜	
猪血豆腐汤	汤羹	菜品	汤羹	
猪软骨乌冬面	乌冬面	主食	面	乌冬面
猫牙香米饭	白米饭	主食	饭	白米饭
猫蒲番茄炒鸡蛋	热菜	菜品	热菜	
猴头菇滑肉汤	汤羹	菜品	汤羹	
猴头菇炖土鸡	汤羹	菜品	汤羹	
猴头菇炖老鸡汤	汤羹	菜品	汤羹	
玉勇大拌菜	凉菜	菜品	凉菜	
玉林大拌菜	凉菜	菜品	凉菜	
玉竹炖老鸭	汤羹	菜品	汤羹	
玉竹老鸭汤	汤羹	菜品	汤羹	
玉米一份炒进饭里	浇头	其他	浇头	
玉米什锦蔬菜粥	粥	主食	粥	
玉米冬瓜排骨汤	汤羹	菜品	汤羹	
玉米冬瓜汤	汤羹	菜品	汤羹	
玉米南瓜小米粥	粥	主食	粥	
玉米南瓜粥	粥	主食	粥	
玉米同骨汤	汤羹	菜品	汤羹	
玉米咸粘粥	粥	主食	粥	
玉米地瓜粥	粥	主食	粥	
玉米大碴粥	粥	主食	粥	
玉米小查粥	粥	主食	粥	
玉米小碴子粥	粥	主食	粥	
玉米小碴粥	粥	主食	粥	
玉米山药炖排骨	热菜	菜品	热菜	
玉米山药猪肚鸡汤饭	泡饭	主食	饭	泡饭
玉米山药粥	粥	主食	粥	
玉米山药龙骨汤	汤羹	菜品	汤羹	
玉米排骨汤	汤羹	菜品	汤羹	
玉米排骨煨汤	汤羹	菜品	汤羹	
玉米排骨粥	粥	主食	粥	
玉米杂骨汤	汤羹	菜品	汤羹	
玉米板栗粥	粥	主食	粥	
玉米榛子粥	粥	主食	粥	
玉米沙拉紫菜包饭	其他饭	主食	饭	其他饭
玉米海带排骨汤加菜饭加小菜	其他菜品	其他	其他菜品	
玉米渣子粥	粥	主食	粥	
玉米火腿粥	粥	主食	粥	
玉米火腿青菜粥	粥	主食	粥	
玉米炒虾仁	热菜	菜品	热菜	
玉米炒青豆	热菜	菜品	热菜	
玉米炒鸡丁	热菜	菜品	热菜	
玉米燕麦粥	粥	主食	粥	
玉米牛奶粥	粥	主食	粥	
玉米甜豆炒虾仁	热菜	菜品	热菜	
玉米瘦肉粥	粥	主食	粥	
玉米瘦肉青菜粥	粥	主食	粥	
玉米碴子粥	粥	主食	粥	
玉米碴红薯粥	粥	主食	粥	
玉米简骨汤	汤羹	菜品	汤羹	
玉米粒包饭	其他饭	主食	饭	其他饭
玉米粒南瓜粥	粥	主食	粥	
玉米粒小炒	热菜	菜品	热菜	
玉米粒米饭	白米饭	主食	饭	白米饭
玉米粗粮面	其他菜品	其他	其他菜品	
玉米糁南瓜粥	粥	主食	粥	
玉米紫菜包饭	其他饭	主食	饭	其他饭
玉米紫薯粥	粥	主食	粥	
玉米红枣炖脊骨	汤羹	菜品	汤羹	
玉米绿豆粥	粥	主食	粥	
玉米肉丝粥	粥	主食	粥	
玉米肉松紫菜包饭	其他饭	主食	饭	其他饭
玉米胡萝卜排骨汤	汤羹	菜品	汤羹	
玉米莲子山药粥	粥	主食	粥	
玉米莲子粥	粥	主食	粥	
玉米菜头汤	汤羹	菜品	汤羹	
玉米菠菜粥	粥	主食	粥	
玉米萝卜排骨汤	汤羹	菜品	汤羹	
玉米蔬菜卤蛋面	盖浇面	主食	面	盖浇面
玉米蔬菜瘦肉粥	粥	主食	粥	
玉米蔬菜粥	粥	主食	粥	
玉米蔬菜糙米饭	健康餐	色拉轻食	健康餐	
玉米虾仁波儿面	汤面	主食	面	汤面
玉米虾仁粥	粥	主食	粥	
玉米蛋奶粥	粥	主食	粥	
玉米蛋花汤	汤羹	菜品	汤羹	
玉米蛋花粥	粥	主食	粥	
玉米青菜粥	粥	主食	粥	
玉米青豆炒虾仁	热菜	菜品	热菜	
玉米面山芋粥	粥	主食	粥	
玉米面拌面	拌面	主食	面	拌面
玉米面蔬菜粥	粥	主食	粥	
玉米饸饹面	汤面	主食	面	汤面
玉米香菇排骨汤	汤羹	菜品	汤羹	
玉米香菇粥	粥	主食	粥	
玉米香菇青菜粥	粥	主食	粥	
玉米骨头汤	热菜	菜品	热菜	
玉米鲜肉馄炖	馄饨	主食	馄饨	
玉米鸡丁饭	盖浇饭	主食	饭	盖浇饭
玉米鸡丝粥	粥	主食	粥	
玉米鸡肉粥	粥	主食	粥	
玉米麦片粥	粥	主食	粥	
玉米黄挂面	其他菜品	其他	其他菜品	
玉菇小炒半份	热菜	菜品	热菜	
王婆大拌菜	凉菜	菜品	凉菜	
王菊烩菜面	汤面	主食	面	汤面
王记大拌菜	凉菜	菜品	凉菜	
玫瑰八宝稀饭	粥	主食	粥	
玫瑰八宝粥	粥	主食	粥	
玫瑰甜稀饭	粥	主食	粥	
玫瑰薏米粥	粥	主食	粥	
玫瑰豆乳山药美龄粥	粥	主食	粥	
玫瑰雪耳炖雪梨	其他甜品	甜点	其他甜品	
现做小米南瓜粥	粥	主食	粥	
现做疙瘩汤	汤羹	菜品	汤羹	
现包蒸饺猪肉芹菜	饺子	主食	饺子	
现卤黄花菜	凉菜	菜品	凉菜	
现拌空心菜	凉菜	菜品	凉菜	
现炒五香豆干	热菜	菜品	热菜	
现炒包心菜	热菜	菜品	热菜	
现炒小青菜	热菜	菜品	热菜	
现炒洋葱炒肉丝	热菜	菜品	热菜	
现炒空心菜	热菜	菜品	热菜	
现炒素交饭	炒饭	主食	饭	炒饭
现炒素什锦	热菜	菜品	热菜	
现炒蛋肉青菜米丝	米线	主食	粉	米线
现炒鲜嫩菜心	热菜	菜品	热菜	
现炒鸡蛋酱	热菜	菜品	热菜	
现炖冰糖雪梨盅	其他甜品	甜点	其他甜品	
现炖盐卤豆腐	热菜	菜品	热菜	
现烧皮蛋瘦肉粥	粥	主食	粥	
现烧韭黄炒蛋	热菜	菜品	热菜	
现煮八宝粥	粥	主食	粥	
现煮小米粥	粥	主食	粥	
现煮紫菜蛋汤	汤羹	菜品	汤羹	
现煮红豆粥	粥	主食	粥	
现煮红豆黑米粥	粥	主食	粥	
现煮蛋包汤	汤羹	菜品	汤羹	
现煮西红柿鸡蛋汤	汤羹	菜品	汤羹	
现煮陈皮绿豆汤	糖水/炖品	甜点	糖水/炖品	
现熬八宝粥	粥	主食	粥	
现熬养胃黑米粥	粥	主食	粥	
现熬南瓜小米粥	粥	主食	粥	
现熬南瓜粥	粥	主食	粥	
现熬小米南瓜粥	粥	主食	粥	
现熬小米粥	粥	主食	粥	
现熬桂花八宝粥	粥	主食	粥	
现熬特浓小豆粥	粥	主食	粥	
现熬玉米粥	粥	主食	粥	
现熬百合莲子粥	粥	主食	粥	
现熬皮蛋瘦肉粥	粥	主食	粥	
现熬紫米八宝粥	粥	主食	粥	
现熬红糖枸杞粥	粥	主食	粥	
现熬绿豆粥	粥	主食	粥	
现熬营养八宝粥	粥	主食	粥	
现熬金瓜小米粥	粥	主食	粥	
现熬香甜小米粥	粥	主食	粥	
现熬黑米粥	粥	主食	粥	
珍品黑米粥	粥	主食	粥	
珍珠五常米饭	白米饭	主食	饭	白米饭
珍珠南瓜粥	粥	主食	粥	
珍珠大米饭	白米饭	主食	饭	白米饭
珍珠白米饭	白米饭	主食	饭	白米饭
珍珠花菜汤	汤羹	菜品	汤羹	
珍珠花菜猪血汤	汤羹	菜品	汤羹	
珍珠香大米饭	白米饭	主食	饭	白米饭
珍珠香米饭	白米饭	主食	饭	白米饭
珍菇素斋饭	盖浇饭	主食	饭	盖浇饭
珍菌剪刀面	汤面	主食	面	汤面
珍菌炒菜心	热菜	菜品	热菜	
珍菌砂锅面	汤面	主食	面	汤面
珍菌类剪刀面	汤面	主食	面	汤面
珍香大米饭	白米饭	主食	饭	白米饭
球菜炒蛋饭	盖浇饭	主食	饭	盖浇饭
瑞丽木耳炒笋尖	热菜	菜品	热菜	
瑶柱白果粥	粥	主食	粥	
瑶柱砂锅粥	粥	主食	粥	
瑶柱肉碎菜心粥	粥	主食	粥	
瑶柱蔬菜粥	粥	主食	粥	
瑶柱虾仁粥	粥	主食	粥	
瑶柱虾米瘦肉粥	粥	主食	粥	
瑶柱韭黄滑蛋炒虾仁	热菜	菜品	热菜	
瑶柱鲜虾粥	粥	主食	粥	
瓜片炒鸡蛋	热菜	菜品	热菜	
瓜片蛋花汤	汤羹	菜品	汤羹	
瓜片鸡蛋汤	汤羹	菜品	汤羹	
瓜片鸡蛋盖饭	盖浇饭	主食	饭	盖浇饭
瓦罐乌鸡汤	汤羹	菜品	汤羹	
瓦罐冬瓜丸子汤	汤羹	菜品	汤羹	
瓦罐山药炖草鸡	热菜	菜品	热菜	
瓦罐煨冬瓜排骨汤	汤羹	菜品	汤羹	
瓦罐牛肉萝卜汤	汤羹	菜品	汤羹	
瓦罐皮蛋瘦肉粥	粥	主食	粥	
瓦罐老鸭汤	汤羹	菜品	汤羹	
瓦罐药膳鸡汤	汤羹	菜品	汤羹	
瓦罐营养大米南瓜粥	粥	主食	粥	
瓦罐营养小米南瓜粥	粥	主食	粥	
瓦罐香糯黑米粥	粥	主食	粥	
瓦香土豆不包含米饭	热菜	菜品	热菜	
瓦香茄子不包含米饭	热菜	菜品	热菜	
甘兰炒粉条	热菜	菜品	热菜	
甘兰鸡蛋炒粉	米线	主食	粉	米线
甘泉优质饸饹荞面	汤面	主食	面	汤面
甘甜丨娃娃菜	蔬菜类	火锅/串串/麻辣烫/色拉自选	配菜	蔬菜类
甘甜南瓜粥	粥	主食	粥	
甘蓝丝炒粉	米线	主食	粉	米线
甘蓝炒粉条	热菜	菜品	热菜	
甜味红枣粥	粥	主食	粥	
甜味黑米粥	粥	主食	粥	
甜心娃娃菜	蔬菜类	火锅/串串/麻辣烫/色拉自选	配菜	蔬菜类
甜心红薯粥	粥	主食	粥	
甜晒虾皮炒青笋丝	热菜	菜品	热菜	
甜椒炒肉丝	热菜	菜品	热菜	
甜炒玉米粒	热菜	菜品	热菜	
甜玉米紫菜包饭	其他饭	主食	饭	其他饭
甜甜蜜蜜南瓜粥	粥	主食	粥	
甜甜蜜蜜红糖红枣红豆粥	粥	主食	粥	
甜糯南瓜粥	粥	主食	粥	
甜糯红豆粥	粥	主食	粥	
甜美娃娃菜	蔬菜类	火锅/串串/麻辣烫/色拉自选	配菜	蔬菜类
甜蜜南瓜粥	粥	主食	粥	
甜蜜黑米粥	粥	主食	粥	
甜豆炒玉米	热菜	菜品	热菜	
甜豆炒虾仁	热菜	菜品	热菜	
甜豆玉米炒虾仁	热菜	菜品	热菜	
甜黑米八宝粥	粥	主食	粥	
生啫空心菜	热菜	菜品	热菜	
生地土伏炖汤	汤羹	菜品	汤羹	
生地熟地麦冬炖排骨	汤羹	菜品	汤羹	
生地玉竹炖龙骨汤	汤羹	菜品	汤羹	
生态娃娃菜	蔬菜类	火锅/串串/麻辣烫/色拉自选	配菜	蔬菜类
生态旱稻米饭	白米饭	主食	饭	白米饭
生态白米饭	白米饭	主食	饭	白米饭
生态菌王汤	汤羹	菜品	汤羹	
生打包猪肉小白菜	饺子	主食	饺子	
生打包猪肉白菜	饺子	主食	饺子	
生氽丸子汤	汤羹	菜品	汤羹	
生汆丸子汤	热菜	菜品	热菜	
生滚三鲜粥	粥	主食	粥	
生滚乌鱼粥	粥	主食	粥	
生滚南瓜粥	粥	主食	粥	
生滚南瓜红薯粥	粥	主食	粥	
生滚干贝鲜虾粥	粥	主食	粥	
生滚牛奶燕麦粥	粥	主食	粥	
生滚牛肉砂锅粥	粥	主食	粥	
生滚牛肉粥	粥	主食	粥	
生滚瘦肉玉米青菜粥	粥	主食	粥	
生滚瘦肉粥	粥	主食	粥	
生滚白米粥	粥	主食	粥	
生滚皮蛋瘦肉粥	粥	主食	粥	
生滚素菜粥	粥	主食	粥	
生滚蔬菜粥	粥	主食	粥	
生滚虾滑粥	粥	主食	粥	
生滚虾蟹瑶柱粥	粥	主食	粥	
生滚青菜瘦肉粥	粥	主食	粥	
生滚青菜粥	粥	主食	粥	
生滚靓白粥	粥	主食	粥	
生滚香菇牛肉粥	粥	主食	粥	
生滚鱼片瘦肉粥	粥	主食	粥	
生滚鱼片粥	粥	主食	粥	
生滚鱼骨腩粥	粥	主食	粥	
生滚鲜虾粥	粥	主食	粥	
生滚龙利鱼片粥	粥	主食	粥	
生炒四季豆	热菜	菜品	热菜	
生炒土豆丝	热菜	菜品	热菜	
生炒大片青笋	热菜	菜品	热菜	
生炒娃娃菜	热菜	菜品	热菜	
生炒小唐菜	热菜	菜品	热菜	
生炒小菜心	热菜	菜品	热菜	
生炒广东菜心	热菜	菜品	热菜	
生炒广东菜心外卖	热菜	菜品	热菜	
生炒扁豆丝	热菜	菜品	热菜	
生炒手撕牛心菜	热菜	菜品	热菜	
生炒散菜花	热菜	菜品	热菜	
生炒有机菜花	热菜	菜品	热菜	
生炒水东芥菜	热菜	菜品	热菜	
生炒油麦菜	热菜	菜品	热菜	
生炒生机菜花	热菜	菜品	热菜	
生炒羽衣甘蓝配蘑菇	健康餐	色拉轻食	健康餐	
生炒芋艿丝	热菜	菜品	热菜	
生炒芥兰苗	热菜	菜品	热菜	
生炒菜心苗	热菜	菜品	热菜	
生炒菜花小份	热菜	菜品	热菜	
生炒菜花饭	炒饭	主食	饭	炒饭
生炒西蓝花苗	热菜	菜品	热菜	
生煲玉米排骨山药粥	粥	主食	粥	
生煲砂锅时蔬粥	粥	主食	粥	
生米煮成的熟饭	白米饭	主食	饭	白米饭
生菜鱼片粥	粥	主食	粥	
生财西生菜	热菜	菜品	热菜	
生鱼砂锅粥	粥	主食	粥	
用木桶蒸的米饭	白米饭	主食	饭	白米饭
田园丰收菜	热菜	菜品	热菜	
田园什锦粥	粥	主食	粥	
田园大拌菜	蔬菜	菜品	色拉	蔬菜
田园小炒皇	热菜	菜品	热菜	
田园小白菜	蔬菜类	火锅/串串/麻辣烫/色拉自选	配菜	蔬菜类
田园小青菜	蔬菜类	火锅/串串/麻辣烫/色拉自选	配菜	蔬菜类
田园时蔬粥	粥	主食	粥	
田园时蔬藜麦粥	粥	主食	粥	
田园油麦菜	蔬菜类	火锅/串串/麻辣烫/色拉自选	配菜	蔬菜类
田园牛肉粥	粥	主食	粥	
田园素抓饭	焖饭	主食	饭	焖饭
田园蔬菜意面	意大利面	主食	面	意大利面
田园蔬菜汤	汤羹	菜品	汤羹	
田园蔬菜粥	粥	主食	粥	
田园豆角茄子肉丝饭	盖浇饭	主食	饭	盖浇饭
田园里的油麦菜	热菜	菜品	热菜	
田园青菜粥	粥	主食	粥	
田园风味山药玉米粥	粥	主食	粥	
田园风味山药青菜粥	粥	主食	粥	
田园风味玉米粥	粥	主食	粥	
田园风味玉米青菜粥	粥	主食	粥	
田园风味田园蔬菜粥	粥	主食	粥	
田园风味蛋花青菜粥	粥	主食	粥	
田园风味青菜香菇粥	粥	主食	粥	
田园鲜虾粥	粥	主食	粥	
畅销皮蛋瘦肉粥	粥	主食	粥	
番茄云吞面	其他面	主食	面	其他面
番茄刀削面	其他面	主食	面	其他面
番茄双拼饭	盖浇饭	主食	饭	盖浇饭
番茄味牛肉汤	汤羹	菜品	汤羹	
番茄味骨汤面	汤面	主食	面	汤面
番茄嘎达汤	汤羹	菜品	汤羹	
番茄园子汤	汤羹	菜品	汤羹	
番茄土豆小排汤	汤羹	菜品	汤羹	
番茄土豆汤	汤羹	菜品	汤羹	
番茄土豆炖牛腩	热菜	菜品	热菜	
番茄土豆牛肉汤	汤羹	菜品	汤羹	
番茄土豆牛肉盖饭	盖浇饭	主食	饭	盖浇饭
番茄土豆牛腩汤	汤羹	菜品	汤羹	
番茄土豆牛腩饭	盖浇饭	主食	饭	盖浇饭
番茄土豆鸡毛菜小排汤	汤羹	菜品	汤羹	
番茄土鸡蛋汤	汤羹	菜品	汤羹	
番茄家户蛋汤	汤羹	菜品	汤羹	
番茄小姐盖饭	盖浇饭	主食	饭	盖浇饭
番茄山药刀削面	其他面	主食	面	其他面
番茄川元汤	汤羹	菜品	汤羹	
番茄意大利斜管面	意大利面	主食	面	意大利面
番茄意大利面	意大利面	主食	面	意大利面
番茄手擀面	手擀面	主食	面	手擀面
番茄手擀面汤	手擀面	主食	面	手擀面
番茄挂汤面	汤面	主食	面	汤面
番茄挂面汤	汤面	主食	面	汤面
番茄排骨土豆汤	汤羹	菜品	汤羹	
番茄时蔬牛肉汤	汤羹	菜品	汤羹	
番茄木耳汤面	汤面	主食	面	汤面
番茄榨菜肉丝鸡蛋汤	汤羹	菜品	汤羹	
番茄榨菜蛋汤	汤羹	菜品	汤羹	
番茄榨菜鸡蛋汤	汤羹	菜品	汤羹	
番茄毛圆汤	汤羹	菜品	汤羹	
番茄毛圆蛋汤	汤羹	菜品	汤羹	
番茄毛白菜	热菜	菜品	热菜	
番茄氽元汤	汤羹	菜品	汤羹	
番茄汁意面	意大利面	主食	面	意大利面
番茄汆元汤	热菜	菜品	热菜	
番茄汤底豆花饭	泡饭	主食	饭	泡饭
番茄浓汤牛肉面	汤面	主食	面	汤面
番茄浓汤面	汤面	主食	面	汤面
番茄滑蛋牛肉饭	盖浇饭	主食	饭	盖浇饭
番茄滑蛋饭	盖浇饭	主食	饭	盖浇饭
番茄炒土鸡蛋	热菜	菜品	热菜	
番茄炒本鸡蛋	热菜	菜品	热菜	
番茄炒柴鸡蛋	热菜	菜品	热菜	
番茄炒牛肉	热菜	菜品	热菜	
番茄炒花菜小份	热菜	菜品	热菜	
番茄炒蛋丨天生一对	热菜	菜品	热菜	
番茄炒蛋丨小拍档	热菜	菜品	热菜	
番茄炒蛋丨小酸甜	热菜	菜品	热菜	
番茄炒蛋份	热菜	菜品	热菜	
番茄炒蛋便当	其他饭	主食	饭	其他饭
番茄炒蛋十米饭	其他菜品	其他	其他菜品	
番茄炒蛋套餐	其他菜品	其他	其他菜品	
番茄炒蛋打卤面	盖浇面	主食	面	盖浇面
番茄炒蛋拌荞麦面	健康餐	色拉轻食	健康餐	
番茄炒蛋拌面	拌面	主食	面	拌面
番茄炒蛋木桶饭	木桶饭	主食	饭	木桶饭
番茄炒蛋浇头	热菜	菜品	热菜	
番茄炒蛋烩饭	烩饭	主食	饭	烩饭
番茄炒蛋煲仔	热菜	菜品	热菜	
番茄炒蛋盖浇面	盖浇面	主食	面	盖浇面
番茄炒蛋盖浇饭	盖浇饭	其他	饭	盖浇饭
番茄炒蛋盖饭	盖浇饭	主食	饭	盖浇饭
番茄炒蛋面	盖浇面	主食	面	盖浇面
番茄炒蛋面疙瘩	汤面	主食	面	汤面
番茄炒蛋饭	盖浇饭	菜品	饭	盖浇饭
番茄炒蛋饭送饮料	盖浇饭	主食	饭	盖浇饭
番茄炒豆腐	热菜	菜品	热菜	
番茄炒面片	炒面	主食	面	炒面
番茄炒鸡蛋	糕点	菜品	糕点	
番茄炒鸡蛋丨小爆炒	热菜	菜品	热菜	
番茄炒鸡蛋小份	热菜	菜品	热菜	
番茄炒鸡蛋盖浇饭	盖浇饭	主食	饭	盖浇饭
番茄炒鸡蛋盖饭	盖浇饭	主食	饭	盖浇饭
番茄炒鸡蛋饭	盖浇饭	主食	饭	盖浇饭
番茄炖牛腩	热菜	菜品	热菜	
番茄炖牛腩煲	热菜	菜品	热菜	
番茄烧花菜	热菜	菜品	热菜	
番茄煎蛋汤	汤羹	菜品	汤羹	
番茄牛肉乌冬面	乌冬面	主食	面	乌冬面
番茄牛肉汤	汤羹	菜品	汤羹	
番茄牛肉汤面	其他面	主食	面	其他面
番茄牛肉汤饭	泡饭	主食	饭	泡饭
番茄牛肉炒面疙瘩	炒面	主食	面	炒面
番茄牛肉炖汤	汤羹	菜品	汤羹	
番茄牛肉粥	粥	主食	粥	
番茄牛肉面	汤面	主食	面	汤面
番茄牛肉饭	盖浇饭	主食	饭	盖浇饭
番茄牛腩炖土豆	热菜	菜品	热菜	
番茄玉米意面	意大利面	主食	面	意大利面
番茄珍珠汤	汤羹	菜品	汤羹	
番茄疙瘩汤	汤羹	菜品	汤羹	
番茄瘦肉粥	粥	主食	粥	
番茄皮卷面	汤面	主食	面	汤面
番茄笋丝面	盖浇面	主食	面	盖浇面
番茄笋干肉丝面	盖浇面	主食	面	盖浇面
番茄笋干蘑菇面	汤面	主食	面	汤面
番茄笋干蛋汤	汤羹	菜品	汤羹	
番茄笋干豆腐汤	汤羹	菜品	汤羹	
番茄素汤面	汤面	主食	面	汤面
番茄素汤饭	泡饭	主食	饭	泡饭
番茄紫菜蛋花汤	汤羹	菜品	汤羹	
番茄红烩意面	意大利面	主食	面	意大利面
番茄肉丸汤	汤羹	菜品	汤羹	
番茄肉元汤	汤羹	菜品	汤羹	
番茄肉圆汤	汤羹	菜品	汤羹	
番茄肉片汤	汤羹	菜品	汤羹	
番茄肉酱面	意大利面	主食	面	意大利面
番茄肥牛粥	粥	主食	粥	
番茄芙蓉汤	汤羹	菜品	汤羹	
番茄菌菇蛋汤	汤羹	菜品	汤羹	
番茄菌菇鸡蛋面	汤面	主食	面	汤面
番茄菜花炒鸡蛋	热菜	菜品	热菜	
番茄虾仁意面	意大利面	主食	面	意大利面
番茄虾仁炒饭	炒饭	主食	饭	炒饭
番茄虾仁炒鸡蛋	热菜	菜品	热菜	
番茄虾仁鸡蛋干拌面	拌面	主食	面	拌面
番茄蛋卤手擀面	手擀面	主食	面	手擀面
番茄蛋汤面	汤面	主食	面	汤面
番茄蛋泡饭	泡饭	主食	饭	泡饭
番茄蛋炒面	炒面	主食	面	炒面
番茄蛋炒饭	炒饭	主食	饭	炒饭
番茄蛋盖饭	盖浇饭	主食	饭	盖浇饭
番茄蛋花汤	热菜	菜品	热菜	
番茄蛋花疙瘩汤	汤羹	菜品	汤羹	
番茄蛋花粥	粥	主食	粥	
番茄豆腐汤	汤羹	菜品	汤羹	
番茄豆腐疙瘩汤	汤羹	菜品	汤羹	
番茄豆腐蛋花疙瘩汤	汤羹	菜品	汤羹	
番茄豆腐鸡蛋汤	汤羹	菜品	汤羹	
番茄酱挂面鸡蛋汤	汤面	主食	面	汤面
番茄酱鸡蛋手擀面汤	手擀面	主食	面	手擀面
番茄酱鸡蛋汤	汤羹	菜品	汤羹	
番茄酱鸡蛋疙瘩汤	汤羹	菜品	汤羹	
番茄酸菜面	汤面	主食	面	汤面
番茄青菜粥	粥	主食	粥	
番茄面疙瘩汤	汤羹	菜品	汤羹	
番茄骨头汤	汤羹	菜品	汤羹	
番茄高丽菜	热菜	菜品	热菜	
番茄鱼片面	汤面	主食	面	汤面
番茄鸡丝炒面	炒面	主食	面	炒面
番茄鸡丝粥	粥	主食	粥	
番茄鸡片盖浇饭	盖浇饭	主食	饭	盖浇饭
番茄鸡片盖饭	盖浇饭	主食	饭	盖浇饭
番茄鸡蛋刀削面	其他面	主食	面	其他面
番茄鸡蛋套饭	其他饭	主食	饭	其他饭
番茄鸡蛋干拌面	拌面	主食	面	拌面
番茄鸡蛋手擀面	手擀面	主食	面	手擀面
番茄鸡蛋打卤面	盖浇面	主食	面	盖浇面
番茄鸡蛋拉面	拉面	主食	面	拉面
番茄鸡蛋拌面	拌面	主食	面	拌面
番茄鸡蛋拌饭	拌饭	主食	饭	拌饭
番茄鸡蛋挂面汤	汤面	主食	面	汤面
番茄鸡蛋捞烩面	其他面	主食	面	其他面
番茄鸡蛋捞面	其他面	主食	面	其他面
番茄鸡蛋旮瘩汤	汤羹	菜品	汤羹	
番茄鸡蛋暖汤	汤羹	菜品	汤羹	
番茄鸡蛋汤	汤羹	菜品	汤羹	
番茄鸡蛋汤面	汤面	主食	面	汤面
番茄鸡蛋炒刀削	其他面	主食	面	其他面
番茄鸡蛋炒刀削面	其他面	主食	面	其他面
番茄鸡蛋炒面	炒面	主食	面	炒面
番茄鸡蛋炒饭	炒饭	主食	饭	炒饭
番茄鸡蛋炒饼	其他主食	主食	其他主食	
番茄鸡蛋烩面	其他面	主食	面	其他面
番茄鸡蛋片儿汤	汤羹	菜品	汤羹	
番茄鸡蛋牛肉粥	粥	主食	粥	
番茄鸡蛋疙瘩汤	汤羹	菜品	汤羹	
番茄鸡蛋盖浇面	盖浇面	主食	面	盖浇面
番茄鸡蛋盖浇饭	盖浇饭	主食	饭	盖浇饭
番茄鸡蛋盖饭	盖浇饭	主食	饭	盖浇饭
番茄鸡蛋素汤面	汤面	主食	面	汤面
番茄鸡蛋肉丝汤	汤羹	菜品	汤羹	
番茄鸡蛋肉丝面	汤面	主食	面	汤面
番茄鸡蛋肉末盖饭	盖浇饭	主食	饭	盖浇饭
番茄鸡蛋菜	热菜	菜品	热菜	
番茄鸡蛋虾仁干挑面	拌面	主食	面	拌面
番茄鸡蛋面	盖浇面	主食	面	盖浇面
番茄鸡蛋饭	盖浇饭	主食	饭	盖浇饭
番茄黄瓜蛋汤	汤羹	菜品	汤羹	
番茄黄金疙瘩汤	汤羹	菜品	汤羹	
番薯干红豆汤	其他甜品	甜点	其他甜品	
疙瘩丝小菜	其他小吃	小吃	其他小吃	
疙瘩汤汤汤汤汤汤	汤羹	菜品	汤羹	
瘦肉丸子面	汤面	主食	面	汤面
瘦肉枸杞叶汤	汤羹	菜品	汤羹	
瘦肉炒大葱	热菜	菜品	热菜	
瘦肉炒芥菜丝	热菜	菜品	热菜	
瘦肉炒香菇	热菜	菜品	热菜	
瘦肉狗杞汤	汤羹	菜品	汤羹	
瘦肉猪润粥	粥	主食	粥	
瘦肉皮蛋粥	粥	主食	粥	
瘦肉砂锅粥	粥	主食	粥	
瘦肉笋丝粥	粥	主食	粥	
瘦肉米粉汤	米线	主食	粉	米线
瘦肉蛋花粥	粥	主食	粥	
瘦肉豆腐汤	粥	主食	粥	
瘦肉青菜粥	粥	主食	粥	
瘦肉香菇粥	粥	主食	粥	
瘦肉鸡蛋盒饭	其他饭	主食	饭	其他饭
瘦身蔬菜炒鸡胸肉三明治	其他甜品	甜点	其他甜品	
白切牛肉粉丝汤	其他粉	主食	粉	其他粉
白山药炒木耳	热菜	菜品	热菜	
白开水鸡蛋汤	汤羹	菜品	汤羹	
白木耳红枣汤	糖水/炖品	甜点	糖水/炖品	
白木耳西米汤	其他甜品	甜点	其他甜品	
白椒罗卜丝炒牛肉丝	热菜	菜品	热菜	
白汤素什锦面	汤面	主食	面	汤面
白汤鲫鱼面	汤面	主食	面	汤面
白洋淀炒鱼片	热菜	菜品	热菜	
白洋淀炖鱼	热菜	菜品	热菜	
白灼农家生菜	热菜	菜品	热菜	
白灼包心菜	热菜	菜品	热菜	
白灼卷心菜	热菜	菜品	热菜	
白灼唐生菜	热菜	菜品	热菜	
白灼园生菜	热菜	菜品	热菜	
白灼圆生菜	热菜	菜品	热菜	
白灼圆白菜	热菜	菜品	热菜	
白灼娃娃菜	蔬菜类	菜品	蔬菜类	
白灼小油菜	热菜	菜品	热菜	
白灼广东生菜	热菜	菜品	热菜	
白灼时令蔬菜	热菜	菜品	热菜	
白灼时令青菜	热菜	菜品	热菜	
白灼本地生菜	热菜	菜品	热菜	
白灼油麦菜	蔬菜类	菜品	配菜	蔬菜类
白灼清炒时蔬	热菜	菜品	热菜	
白灼球生菜	热菜	菜品	热菜	
白灼罗马生菜	热菜	菜品	热菜	
白灼罗马西生菜	凉菜	菜品	凉菜	
白灼蒜蓉西生菜	热菜	菜品	热菜	
白灼西洋生菜	热菜	菜品	热菜	
白灼西生菜	热菜	菜品	热菜	
白灼青油菜	热菜	菜品	热菜	
白灼马生菜	热菜	菜品	热菜	
白灼高山娃娃菜	热菜	菜品	热菜	
白玉菇炒秋葵	热菜	菜品	热菜	
白玉菇炒肉	热菜	菜品	热菜	
白玉菇炒肉丝	热菜	菜品	热菜	
白玉菇炒鸡蛋	热菜	菜品	热菜	
白白香米饭	白米饭	主食	饭	白米饭
白米大豆饭	白米饭	主食	饭	白米饭
白米粥加小菜	粥	主食	粥	
白米粥加配菜	粥	主食	粥	
白米粥十小菜	粥	主食	粥	
白米粥配小菜	粥	主食	粥	
白米绿豆冰粥	糖水/炖品	甜点	糖水/炖品	
白米绿豆粥	粥	主食	粥	
白粥加小菜	粥	主食	粥	
白粥配榨菜	粥	主食	粥	
白罗卜骨头汤	汤羹	菜品	汤羹	
白肉炖酸菜	热菜	菜品	热菜	
白肚粉丝汤	其他粉	主食	粉	其他粉
白芹菜炒牛肉	热菜	菜品	热菜	
白莲藕炒肉片	热菜	菜品	热菜	
白菜丸子汤	汤羹	菜品	汤羹	
白菜丸子炖粉条	热菜	菜品	热菜	
白菜丸子炖粉条小份	热菜	菜品	热菜	
白菜五花豆腐炖粉条	热菜	菜品	热菜	
白菜加散菜	热菜	菜品	热菜	
白菜叶炒明虾	热菜	菜品	热菜	
白菜大锅菜	热菜	菜品	热菜	
白菜心娃娃菜	蔬菜类	火锅/串串/麻辣烫/色拉自选	配菜	蔬菜类
白菜木耳丸子盖饭	盖浇饭	主食	饭	盖浇饭
白菜木耳干豆腐炒	热菜	菜品	热菜	
白菜木耳炒干豆腐	热菜	菜品	热菜	
白菜木耳炒肉	热菜	菜品	热菜	
白菜木耳爆豆腐盖饭	盖浇饭	主食	饭	盖浇饭
白菜木耳爆豆腐饭	盖浇饭	主食	饭	盖浇饭
白菜海兔炖粉	热菜	菜品	热菜	
白菜炒木耳	热菜	菜品	热菜	
白菜炒木耳一份	热菜	菜品	热菜	
白菜炒油豆腐	热菜	菜品	热菜	
白菜炒粉丝	热菜	菜品	热菜	
白菜炒粉条	热菜	菜品	热菜	
白菜炒素丸子	热菜	菜品	热菜	
白菜炒素丸子盖饭	盖浇饭	主食	饭	盖浇饭
白菜炒肉丝	热菜	菜品	热菜	
白菜炒芋头	热菜	菜品	热菜	
白菜炒豆皮	热菜	菜品	热菜	
白菜炒豆腐	热菜	菜品	热菜	
白菜炒闷子	热菜	菜品	热菜	
白菜炒香干	热菜	菜品	热菜	
白菜炒香菇	热菜	菜品	热菜	
白菜炖冻豆腐	热菜	菜品	热菜	
白菜炖冻豆腐粉	热菜	菜品	热菜	
白菜炖粉条	热菜	菜品	热菜	
白菜炖老豆腐	热菜	菜品	热菜	
白菜炖肉丸	热菜	菜品	热菜	
白菜炖肉片	热菜	菜品	热菜	
白菜炖腐皮	热菜	菜品	热菜	
白菜炖豆腐	热菜	菜品	热菜	
白菜炖豆腐粉条	热菜	菜品	热菜	
白菜片木耳炒肉	热菜	菜品	热菜	
白菜片炒木耳	热菜	菜品	热菜	
白菜片炒红蘑	热菜	菜品	热菜	
白菜片炒蘑菇	热菜	菜品	热菜	
白菜牛肉盖浇饭	盖浇饭	主食	饭	盖浇饭
白菜牛肉饭	盖浇饭	主食	饭	盖浇饭
白菜猪肉炖粉条	热菜	菜品	热菜	
白菜瘦肉汤	汤羹	菜品	汤羹	
白菜粉丝豆腐汤	汤羹	菜品	汤羹	
白菜粉条包有鸡蛋里面	其他包子	主食	包子	其他包子
白菜粉条带汤	其他粉	主食	粉	其他粉
白菜粉条炖丸子	热菜	菜品	热菜	
白菜粉条炖丸孑	热菜	菜品	热菜	
白菜粉条炖冻豆腐	热菜	菜品	热菜	
白菜粉条炖豆腐	热菜	菜品	热菜	
白菜肉丝炒菜	热菜	菜品	热菜	
白菜肉丝盖浇饭	盖浇饭	主食	饭	盖浇饭
白菜肉丝面	汤面	主食	面	汤面
白菜肉丝饭	盖浇饭	主食	饭	盖浇饭
白菜蘑菇汤	汤羹	菜品	汤羹	
白菜虾皮炖豆腐	热菜	菜品	热菜	
白菜蛋炒河粉	其他粉	主食	粉	其他粉
白菜蛋炒面	炒面	主食	面	炒面
白菜豆腐养生汤	汤羹	菜品	汤羹	
白菜豆腐圆子汤	汤羹	菜品	汤羹	
白菜豆腐大锅菜	热菜	菜品	热菜	
白菜豆腐汤	汤羹	菜品	汤羹	
白菜豆腐炒粉条	热菜	菜品	热菜	
白菜豆腐炖五花	热菜	菜品	热菜	
白菜豆腐炖粉条	热菜	菜品	热菜	
白菜豆腐炖粉条盖饭	盖浇饭	主食	饭	盖浇饭
白菜豆腐炖肉	热菜	菜品	热菜	
白菜豆腐炖肉粉条	热菜	菜品	热菜	
白菜豆腐粉丝汤	热菜	菜品	粉	其他粉
白菜豆腐粉条炖肉	热菜	菜品	热菜	
白菜豆腐肉片汤	汤羹	菜品	汤羹	
白菜豆腐蛋花汤	汤羹	菜品	汤羹	
白菜豆腐鸭架汤	汤羹	菜品	汤羹	
白菜鸡蛋炒馒头	馒头	菜品	馒头	
白菜鸡蛋炝锅面	汤面	主食	面	汤面
白萝卜丝炒小虾	热菜	菜品	热菜	
白萝卜丸子汤	热菜	菜品	热菜	
白萝卜手工什锦瘦肉丸子汤	汤羹	菜品	汤羹	
白萝卜排骨汤	汤羹	菜品	汤羹	
白萝卜炖骨头	汤羹	菜品	汤羹	
白萝卜烧芹菜	热菜	菜品	热菜	
白萝卜牛肉汤	汤羹	菜品	汤羹	
白萝卜疙瘩汤	汤羹	菜品	汤羹	
白萝卜骨头汤	汤羹	菜品	汤羹	
白萝卜龙骨汤	汤羹	菜品	汤羹	
白薯面饸饹面	拌面	主食	面	拌面
白蘑菇炒肉片	热菜	菜品	热菜	
白虾新雪菜	热菜	菜品	热菜	
白虾炒萝卜丝	热菜	菜品	热菜	
白虾炒青菜	热菜	菜品	热菜	
白虾烧芥菜	热菜	菜品	热菜	
白蟹豆腐汤	汤羹	菜品	汤羹	
白饼子夹菜	夹饼/夹馍	主食	饼/囊/馍	夹饼/夹馍
白黄瓜炒虾皮	热菜	菜品	热菜	
百叶包粉丝汤	其他粉	主食	粉	其他粉
百叶包青菜粉丝汤	其他粉	主食	粉	其他粉
百叶卷香菜	蔬菜类	烧烤	蔬菜类	
百叶米粉汤	米线	主食	粉	米线
百合养生粥	粥	主食	粥	
百合养胃粥	粥	主食	粥	
百合南瓜小米粥	粥	主食	粥	
百合南瓜粥	粥	主食	粥	
百合杏仁粥	粥	主食	粥	
百合桂圆莲子粥	粥	主食	粥	
百合炒河虾仁	热菜	菜品	热菜	
百合炒虾仁	热菜	菜品	热菜	
百合瘦肉粥	粥	主食	粥	
百合红枣粥	粥	主食	粥	
百合红枣绿豆汤	糖水/炖品	甜点	糖水/炖品	
百合绿豆汤	糖水/炖品	菜品	糖水/炖品	
百合绿豆粥	粥	主食	粥	
百合芦荟粥	粥	主食	粥	
百合莲子枸杞粥	粥	主食	粥	
百合莲子炖雪梨	其他甜品	甜点	其他甜品	
百合莲子牛肉粥	粥	主食	粥	
百合莲子猪肚汤	汤羹	菜品	汤羹	
百合莲子粥	粥	主食	粥	
百合莲子绿豆粥	粥	主食	粥	
百合银耳枸杞粥	粥	主食	粥	
百合银耳炖桃胶	其他甜品	甜点	其他甜品	
百合银耳炖雪梨	其他甜品	甜点	其他甜品	
百合雪梨汤	其他甜品	甜点	其他甜品	
百合雪梨粥	粥	主食	粥	
百合马蹄炖雪梨	其他甜品	甜点	其他甜品	
百姓小炒皇	热菜	菜品	热菜	
百家黑米粥	粥	主食	粥	
百灵草炖鸭	热菜	菜品	热菜	
百灵草的鸽子汤	汤羹	菜品	汤羹	
百灵草鸽子汤	汤羹	菜品	汤羹	
百福百财大白菜	热菜	菜品	热菜	
皇城根儿打卤面	盖浇面	主食	面	盖浇面
皎白炒肉丝	热菜	菜品	热菜	
皮旦瘦肉粥	粥	主食	粥	
皮旦瘦肉青菜粥	粥	主食	粥	
皮旦瘦肉香菇粥	粥	主食	粥	
皮皮虾肉炒菠菜	热菜	菜品	热菜	
皮皮蛋瘦肉粥	粥	主食	粥	
皮肉瘦肉粥	粥	主食	粥	
皮蛋冬瓜汤	汤羹	菜品	汤羹	
皮蛋冬瓜瘦肉汤	汤羹	菜品	汤羹	
皮蛋冬瓜肉丝汤	汤羹	菜品	汤羹	
皮蛋干贝砂锅粥	粥	主食	粥	
皮蛋廋肉粥	粥	主食	粥	
皮蛋燕麦粥	粥	主食	粥	
皮蛋爱上瘦肉粥	粥	主食	粥	
皮蛋玉米粥	粥	主食	粥	
皮蛋痩肉粥	粥	主食	粥	
皮蛋瘦肉大王粥	粥	主食	粥	
皮蛋瘦肉瓦罐粥	粥	主食	粥	
皮蛋瘦肉生滚粥	粥	主食	粥	
皮蛋瘦肉疏菜粥	粥	主食	粥	
皮蛋瘦肉砂锅粥	粥	其他	粥	
皮蛋瘦肉稀饭	粥	主食	粥	
皮蛋瘦肉粥	糖水/炖品	菜品	糖水/炖品	
皮蛋瘦肉粥粥	粥	主食	粥	
皮蛋瘦肉粥送咸菜	粥	主食	粥	
皮蛋瘦肉菠菜粥	粥	主食	粥	
皮蛋瘦肉蔬菜粥	粥	主食	粥	
皮蛋瘦肉青菜粥	粥	主食	粥	
皮蛋瘦肉鲜滚粥	粥	主食	粥	
皮蛋瘦肉黄瓜汤	汤羹	菜品	汤羹	
皮蛋粉丝鱼片汤	汤羹	菜品	汤羹	
皮蛋蔬菜瘦肉粥	粥	主食	粥	
皮蛋蔬菜粥	粥	主食	粥	
皮蛋蛋花粥	粥	主食	粥	
皮蛋青瓜汤	汤羹	菜品	汤羹	
皮蛋青菜粥	粥	主食	粥	
皮蛋香菇瘦肉粥	粥	主食	粥	
皮蛋香菇粥	粥	主食	粥	
皮蛋鱼头豆腐汤	汤羹	菜品	汤羹	
皮蛋鱼片粥	粥	主食	粥	
皮蛋鸡丝粥	粥	主食	粥	
皮蛋鸡肉粥	粥	主食	粥	
盆盆玉米面	汤面	主食	面	汤面
盆装小炒脆藕	热菜	菜品	热菜	
益寿养生粥	粥	主食	粥	
益寿南瓜粥	粥	主食	粥	
益气鲜蛎粥	粥	主食	粥	
盐水白灼生菜	热菜	菜品	热菜	
盐菜豆腐佬汤	汤羹	菜品	汤羹	
盐蛋瘦肉粥	粥	主食	粥	
盒装黑米粥	粥	主食	粥	
盖菜炒虾米	热菜	菜品	热菜	
盖菜虾米粥	粥	主食	粥	
盖饭西红柿炒鸡蛋	盖浇饭	主食	饭	盖浇饭
盘菜炒芹菜	热菜	菜品	热菜	
盘菜烧芹菜	热菜	菜品	热菜	
盘锦大米饭	白米饭	主食	饭	白米饭
盘锦蟹田米饭	白米饭	主食	饭	白米饭
目鱼大白菜	热菜	菜品	热菜	
目鱼炒芹菜	热菜	菜品	热菜	
相思红豆粥	粥	主食	粥	
看得见鮸鱼的鱼圆汤	汤羹	菜品	汤羹	
真果味什锦水果汤	其他甜品	甜点	其他甜品	
真正稻花香米饭	白米饭	主食	饭	白米饭
真真老老元气黑米粥	粥	主食	粥	
真菌油麦菜	热菜	菜品	热菜	
真菌炒菜心	热菜	菜品	热菜	
石斑鱼削骨肉粥	粥	主食	粥	
石斑鱼排骨粥	粥	主食	粥	
石斑鱼片粥	粥	主食	粥	
石斑鱼肉粥	粥	主食	粥	
石斛养生鸽子汤	汤羹	菜品	汤羹	
石斛响螺鲍鱼汤	汤羹	菜品	汤羹	
石海鱼片粥	粥	主食	粥	
石锅娃娃菜	热菜	菜品	热菜	
石锅嫩豆腐汤	汤羹	菜品	汤羹	
石锅小鸡炖蘑菇	热菜	菜品	热菜	
石锅干锅花菜	热菜	菜品	热菜	
石锅海带汤	汤羹	菜品	汤羹	
石锅茄子加米饭	其他菜品	其他	其他菜品	
石锅蔬菜拌饭	拌饭	主食	饭	拌饭
石锅豆腐加米饭	其他菜品	其他	其他菜品	
石锅酸菜加米饭	其他菜品	其他	其他菜品	
石锅鸡肉汤	其他菜品	其他	其他菜品	
砂仁白扣猪肚汤	汤羹	菜品	汤羹	
砂煲娃娃菜	热菜	菜品	热菜	
砂锅三鲜汤	汤羹	菜品	汤羹	
砂锅上汤娃娃菜	热菜	菜品	热菜	
砂锅丸子小白菜	热菜	菜品	热菜	
砂锅丸子木耳小白菜	热菜	菜品	热菜	
砂锅丸子汤	汤羹	菜品	汤羹	
砂锅农家花菜	热菜	菜品	热菜	
砂锅冬瓜丸子汤	汤羹	菜品	汤羹	
砂锅冰糖炖雪梨银耳汤二人份	其他甜品	甜点	其他甜品	
砂锅冰糖雪梨炖银耳一人份	其他甜品	甜点	其他甜品	
砂锅剪刀面	汤面	主食	面	汤面
砂锅包菜小炒皇	热菜	菜品	热菜	
砂锅土鸡煨汤	汤羹	菜品	汤羹	
砂锅娃娃菜	热菜	菜品	热菜	
砂锅小鸡炖蘑菇	热菜	菜品	热菜	
砂锅手工面	手擀面	主食	面	手擀面
砂锅手擀面	手擀面	主食	面	手擀面
砂锅水芹菜	热菜	菜品	热菜	
砂锅清炖土鸡	热菜	菜品	热菜	
砂锅清炖鸡	热菜	菜品	热菜	
砂锅焗娃娃菜	热菜	菜品	热菜	
砂锅牛肉炖萝卜	热菜	菜品	热菜	
砂锅牛肉粥	粥	主食	粥	
砂锅瑶柱菜心粥	粥	主食	粥	
砂锅番茄刀削面	其他面	主食	面	其他面
砂锅番茄花菜	热菜	菜品	热菜	
砂锅白米粥	粥	主食	粥	
砂锅皮蛋瘦肉粥	粥	主食	粥	
砂锅笋衣炖台州豆腐	热菜	菜品	热菜	
砂锅粉丝炖菜	热菜	菜品	热菜	
砂锅素烩面	其他面	主食	面	其他面
砂锅莲藕汤	汤羹	菜品	汤羹	
砂锅菌菇汤	汤羹	菜品	汤羹	
砂锅菠菜蛋花汤	汤羹	菜品	汤羹	
砂锅萝卜炖牛腩	热菜	菜品	热菜	
砂锅西红柿炖牛肉	热菜	菜品	热菜	
砂锅豆付小白菜	热菜	菜品	热菜	
砂锅豆腐丸子小白菜	热菜	菜品	热菜	
砂锅豆腐小白菜	热菜	菜品	热菜	
砂锅豆腐汤	热菜	菜品	热菜	
砂锅豆腐海米紫菜	热菜	菜品	热菜	
砂锅豆腐粉丝汤	其他粉	主食	粉	其他粉
砂锅豆腐菜	热菜	菜品	热菜	
砂锅青菜瘦肉粥	粥	主食	粥	
砂锅青鱼炖豆腐	热菜	菜品	热菜	
砂锅香菇瘦肉粥	粥	主食	粥	
砂锅鸡肉米线十素菜	米线	主食	粉	米线
砂锅鸡肉粥	粥	主食	粥	
砂锅龙须面	汤面	主食	面	汤面
硕粥粮八宝粥	粥	主食	粥	
硕粮燕麦粥	粥	主食	粥	
碎木耳炒鸡蛋	热菜	菜品	热菜	
碎椒炒香干	热菜	菜品	热菜	
碎椒炒鸡蛋	热菜	菜品	热菜	
碎肉香菇煲饭	煲仔饭	主食	饭	煲仔饭
碎花鸡蛋番茄面	汤面	主食	面	汤面
碎黄瓜炒肉	热菜	菜品	热菜	
碗豆米炒肉丁	热菜	菜品	热菜	
碗豆米炒肉丝	热菜	菜品	热菜	
碳烤卷心菜	蔬菜类	烧烤	蔬菜类	
碳烤圆白菜	蔬菜类	烧烤	蔬菜类	
碳烤娃娃菜	蔬菜类	烧烤	蔬菜类	
碳烤油麦菜	蔬菜类	烧烤	蔬菜类	
碳烤洋白菜	蔬菜类	烧烤	蔬菜类	
磨姑炒牛肉	热菜	菜品	热菜	
磨菇炒肉丝	热菜	菜品	热菜	
磨菇炒肉片	热菜	菜品	热菜	
磨菇炒肉盖浇饭	盖浇饭	主食	饭	盖浇饭
祖传炒合菜	热菜	菜品	热菜	
祘泥空心菜	热菜	菜品	热菜	
神仙小米粥	粥	主食	粥	
神厨大白菜	热菜	菜品	热菜	
神厨炖酸菜	热菜	菜品	热菜	
福寿卤香黄豆面	汤面	主食	面	汤面
福寿腊八粥	粥	主食	粥	
福州鱼丸汤	汤羹	菜品	汤羹	
福来炒合菜	热菜	菜品	热菜	
福气八宝粥	粥	主食	粥	
福满八宝粥	粥	主食	粥	
福满腊八粥	粥	主食	粥	
福状元烩菜	热菜	菜品	热菜	
福田裙带菜	凉菜	菜品	凉菜	
福记大烩菜	热菜	菜品	热菜	
福运八宝粥	粥	主食	粥	
秀珍菇小炒	热菜	菜品	热菜	
私厨蔬菜炒饭	炒饭	主食	饭	炒饭
私房外婆菜	热菜	菜品	热菜	
私房娃娃菜	热菜	菜品	热菜	
私房疙瘩汤	汤羹	菜品	汤羹	
私房空心菜	热菜	菜品	热菜	
私房豆腐饭	盖浇饭	主食	饭	盖浇饭
秋天的菠菜	凉菜	菜品	凉菜	
秋季养生菜	热菜	菜品	热菜	
秋木耳炒山药	热菜	菜品	热菜	
秋田小町米饭	白米饭	主食	饭	白米饭
秋田小町香米饭	白米饭	主食	饭	白米饭
秋耳大白菜	凉菜	菜品	凉菜	
秋耳炒山药	热菜	菜品	热菜	
秋耳炒铁杆山药	热菜	菜品	热菜	
秋葵山药炖排骨	热菜	菜品	热菜	
秋葵木耳炒走地鸡蛋	热菜	菜品	热菜	
秋葵炒山药	热菜	菜品	热菜	
秋葵炒杏包菇	热菜	菜品	热菜	
秋葵炒杏鲍菇	热菜	菜品	热菜	
秋葵炒虾仁	热菜	菜品	热菜	
秋葵炒鸡蛋	热菜	菜品	热菜	
秋葵炖长山药	热菜	菜品	热菜	
秋葵虾仁炒蛋	热菜	菜品	热菜	
秋葵青椒炒牛肉	热菜	菜品	热菜	
秘制乌冬面	乌冬面	主食	面	乌冬面
秘制八宝粥	粥	主食	粥	
秘制八宝菜	凉菜	菜品	凉菜	
秘制圆白菜	热菜	菜品	热菜	
秘制大拌菜	凉菜	菜品	凉菜	
秘制牛骨清汤	汤羹	菜品	汤羹	
秘制绿豆粥	粥	主食	粥	
秘制茄子盖饭	盖浇饭	主食	饭	盖浇饭
秘制荞麦面	凉面	主食	面	凉面
秘制萝卜炖牛肉	热菜	菜品	热菜	
秘制豆腐拌饭	拌饭	主食	饭	拌饭
秘制酱炒鸡蛋小份	热菜	菜品	热菜	
秘制香米饭	白米饭	主食	饭	白米饭
秘制香菇面	汤面	主食	面	汤面
秘制黄瓜小咸菜	凉菜	菜品	凉菜	
秦岭灰灰菜	热菜	菜品	热菜	
稠香厚实南瓜粥	粥	主食	粥	
稻花香五常大米饭	白米饭	主食	饭	白米饭
稻花香有机大米饭	白米饭	主食	饭	白米饭
稻花香现煮米饭	白米饭	主食	饭	白米饭
稻花香白米饭	白米饭	主食	饭	白米饭
稻花香米粥	粥	主食	粥	
稻花香米饭	盖浇饭	主食	饭	盖浇饭
稻香村优质大米饭	白米饭	主食	饭	白米饭
稻香白米饭	白米饭	主食	饭	白米饭
空心菜清炒	热菜	菜品	热菜	
空心菜炒牛肉	热菜	菜品	热菜	
空心菜炒肉丝	热菜	菜品	热菜	
窝窝头外婆菜	热菜	菜品	热菜	
窝窝头湘西外婆菜	馒头	主食	馒头	
窝笋炒肉丝	热菜	菜品	热菜	
窝笋炒肉片	热菜	菜品	热菜	
窝蛋牛肉健力粥	粥	主食	粥	
窝蛋牛肉末粥	粥	主食	粥	
窝蛋牛肉清远鸡粥	粥	主食	粥	
窝蛋牛肉粥	粥	主食	粥	
立春炒和菜	热菜	菜品	热菜	
童年罗宋汤	汤羹	菜品	汤羹	
童年记忆里的疙瘩汤	汤羹	菜品	汤羹	
竹叶菜梗炒肉丝	热菜	菜品	热菜	
竹笋炒肉丝	热菜	菜品	热菜	
竹笋炒雪菜	热菜	菜品	热菜	
竹笙干贝萝卜汤	汤羹	菜品	汤羹	
竹笙炖土鳮盅	热菜	菜品	热菜	
竹荪三鲜汤	汤羹	菜品	汤羹	
竹荪红枣老母鸡汤	汤羹	菜品	汤羹	
竹荪菌菇奶香烩饭	烩饭	主食	饭	烩饭
笃笃鲜烂糊面	汤面	主食	面	汤面
笋丝炒肉丝	热菜	菜品	热菜	
笋丝野芹菜	热菜	菜品	热菜	
笋丝鸡毛菜	热菜	菜品	热菜	
笋子菌汤面	汤面	主食	面	汤面
笋尖木耳炖鸡汤	汤羹	菜品	汤羹	
笋尖木耳面	汤面	主食	面	汤面
笋尖炒米粉	米线	主食	粉	米线
笋尖炒肉片	热菜	菜品	热菜	
笋尖疏菜饭	盖浇饭	主食	饭	盖浇饭
笋尖老鸭汤	汤羹	菜品	汤羹	
笋尖肉丝面	汤面	主食	面	汤面
笋干小炒盖饭	盖浇饭	主食	饭	盖浇饭
笋干干挑面	拌面	主食	面	拌面
笋干炒丝瓜	热菜	菜品	热菜	
笋干炒肉丝	热菜	菜品	热菜	
笋干炒芹菜	热菜	菜品	热菜	
笋干炖老鸭	热菜	菜品	热菜	
笋干番茄汤	汤羹	菜品	汤羹	
笋干肉丝面	汤面	主食	面	汤面
笋干菜丝瓜番茄虾干汤	汤羹	菜品	汤羹	
笋干菜苋菜	热菜	菜品	热菜	
笋干菜蛋花汤	汤羹	菜品	汤羹	
笋片莴苣片炒肉片	热菜	菜品	热菜	
笋衣炒鸡蛋	热菜	菜品	热菜	
笔管炒小白菜	热菜	菜品	热菜	
笔管炖豆腐	热菜	菜品	热菜	
笔管白菜炖豆腐	热菜	菜品	热菜	
笔管豆腐白菜	热菜	菜品	热菜	
笔管鱼大虾炖豆腐	热菜	菜品	热菜	
笔管鱼小白菜	热菜	菜品	热菜	
笔管鱼炒小白菜	热菜	菜品	热菜	
笔管鱼烩小白菜	热菜	菜品	热菜	
笔管鱼鱼炖豆腐	热菜	菜品	热菜	
笨炒绿豆芽	热菜	菜品	热菜	
笨猪肉白菜	饺子	主食	饺子	
笨豆芽小炒	热菜	菜品	热菜	
笨豆芽炒干豆腐	热菜	菜品	热菜	
笨豆芽炒粉大份	热菜	菜品	热菜	
笨豆芽炒粉小份	热菜	菜品	热菜	
笨豆芽炒韭菜	热菜	菜品	热菜	
笨鸡炖松蘑	热菜	菜品	热菜	
笨鸡炖花菇	热菜	菜品	热菜	
笨鸡炖蘑菇	热菜	菜品	热菜	
笨鸡炖酸菜粉条	热菜	菜品	热菜	
笨鸡炖香菇	热菜	菜品	热菜	
笨鸡蛋炒木耳	热菜	菜品	热菜	
笨鸡蛋炒栲栳栳	炒面	主食	面	炒面
笨鸡蛋炒菠菜	热菜	菜品	热菜	
笨鸡蛋碰石头小碗菜	热菜	菜品	热菜	
筒子萝卜汤	汤羹	菜品	汤羹	
筒骨玉米蔬菜米饭	其他饭	主食	饭	其他饭
简简单单素炒洋芋擦擦	热菜	菜品	热菜	
简菜家乡外婆菜	热菜	菜品	热菜	
简菜清炒芥兰	热菜	菜品	热菜	
简菜清炒西兰花	热菜	菜品	热菜	
简菜西红柿炒鸡蛋	热菜	菜品	热菜	
简菜铁棍山药炒木耳	热菜	菜品	热菜	
简豆角白炒蘑菇	热菜	菜品	热菜	
管氏疙瘩汤	粥	菜品	粥	
米粉西洋菜汤	米线	主食	粉	米线
米粒疙瘩汤	汤羹	菜品	汤羹	
米饭不浇汤	白米饭	主食	饭	白米饭
米饭两元米饭	白米饭	主食	饭	白米饭
米饭米饭米饭	白米饭	主食	饭	白米饭
米饼夹炒鸡蛋	夹饼/夹馍	主食	饼/囊/馍	夹饼/夹馍
籽米养血粥	粥	主食	粥	
粉丝乌鸡汤	其他粉	主食	粉	其他粉
粉丝包心菜	热菜	菜品	热菜	
粉丝包菜炒鸡蛋	热菜	菜品	热菜	
粉丝圆白菜	热菜	菜品	热菜	
粉丝娃娃菜	热菜	菜品	热菜	
粉丝小白菜	热菜	菜品	热菜	
粉丝拌菠菜	凉菜	菜品	凉菜	
粉丝炒包包白	热菜	菜品	热菜	
粉丝炒包心菜	热菜	菜品	热菜	
粉丝炒包菜	热菜	菜品	热菜	
粉丝炒甘蓝	热菜	菜品	热菜	
粉丝炒豆芽	热菜	菜品	热菜	
粉丝炒鸡蛋	热菜	菜品	热菜	
粉丝煸包心菜	热菜	菜品	热菜	
粉丝蒸白菜	热菜	菜品	热菜	
粉丝青菜汤	汤羹	菜品	汤羹	
粉条油菜炒鸡蛋	热菜	菜品	热菜	
粉条炒圆白菜	热菜	菜品	热菜	
粉条炒肉沫	热菜	菜品	热菜	
粉条炒豆芽	热菜	菜品	热菜	
粉条炖豆角	热菜	菜品	热菜	
粉皮炒鸡蛋	热菜	菜品	热菜	
粉皮炒鸡蛋套餐	热菜	菜品	热菜	
粉皮炒鸭蛋	热菜	菜品	热菜	
粉葛赤小豆煲龙骨汤	汤羹	菜品	汤羹	
粉蒸时令菜	热菜	菜品	热菜	
粉面两掺素菜	其他粉	主食	粉	其他粉
粒粒香农家乱炖	热菜	菜品	热菜	
粒粒香木桶米饭	白米饭	主食	饭	白米饭
粒粒香白米饭	白米饭	主食	饭	白米饭
粒粒香米饭	白米饭	主食	饭	白米饭
粗玉米面砂锅面	汤面	主食	面	汤面
粗粮大碴粥	粥	主食	粥	
粗粮小米粥	粥	主食	粥	
粗粮御米面	汤面	主食	面	汤面
粗粮玉米面粥	粥	主食	粥	
粗粮糙米饭	浇头	其他	浇头	
粗粮细作面	其他菜品	其他	其他菜品	
粗粮营养粥	粥	主食	粥	
粘玉米大碴粥	粥	主食	粥	
粟米鱼柳饭	拌饭	主食	饭	拌饭
粤式生滚鱼片粥	粥	主食	粥	
粥拌鲜小咸菜	凉菜	菜品	凉菜	
粥掌柜南瓜粥	粥	主食	粥	
粥王皮蛋瘦肉粥	粥	主食	粥	
精制黑米粥	粥	主食	粥	
精品八宝粥	粥	主食	粥	
精品刀削面	其他面	主食	面	其他面
精品南瓜山药粥	粥	主食	粥	
精品南瓜粥	粥	主食	粥	
精品原味刀削面	其他面	主食	面	其他面
精品大烩菜	热菜	菜品	热菜	
精品娃娃菜	蔬菜类	烧烤	配菜	蔬菜类
精品手撕圆白菜	热菜	菜品	热菜	
精品油麦菜	蔬菜类	火锅/串串/麻辣烫/色拉自选	配菜	蔬菜类
精品混合汤	汤羹	菜品	汤羹	
精品烙馍卷菜	卷饼	主食	饼/囊/馍	卷饼
精品玉米面	其他菜品	其他	其他菜品	
精品紫菜汤	汤羹	菜品	汤羹	
精品红叶菜	蔬菜类	火锅/串串/麻辣烫/色拉自选	配菜	蔬菜类
精品腊八粥	粥	主食	粥	
精品茼蒿菜	蔬菜类	火锅/串串/麻辣烫/色拉自选	配菜	蔬菜类
精品营养南瓜粥	粥	主食	粥	
精品香葱炒鸡蛋套餐	其他菜品	其他	其他菜品	
精妙疙瘩汤	汤羹	菜品	汤羹	
精心熬制小米粥	粥	主食	粥	
精炒四样小份	热菜	菜品	热菜	
精炖山药鸡汤	汤羹	菜品	汤羹	
精熬八宝粥	粥	主食	粥	
精瘦肉香菇木耳素臊子双拼鸡汤面	汤面	主食	面	汤面
精美农家拌菜	凉菜	菜品	凉菜	
精美豆芽菜	热菜	菜品	热菜	
精致娃娃菜	蔬菜类	火锅/串串/麻辣烫/色拉自选	配菜	蔬菜类
精致碗汤炒小份	汤羹	菜品	汤羹	
糖小米南瓜粥	粥	主食	粥	
糖炒小山楂大份	热菜	菜品	热菜	
糖炒山药豆	热菜	菜品	热菜	
糖炒栗子小份	热菜	菜品	热菜	
糖醋大白菜	热菜	菜品	热菜	
糙米藜麦牛肉饭	健康餐	色拉轻食	健康餐	
糙米藜麦菌菇酱香炒饭	炒饭	主食	饭	炒饭
糯米乌鸡汤	汤羹	菜品	汤羹	
糯米南瓜粥	粥	主食	粥	
糯米大枣粥	粥	主食	粥	
糯米桂花粥	粥	主食	粥	
糯米汤乌鸡汤	汤羹	菜品	汤羹	
糯米红薯粥	粥	主食	粥	
糯米绿豆粥	粥	主食	粥	
糯米荷叶粥	粥	主食	粥	
糯香八宝粥	粥	主食	粥	
素三丝冷面	其他主食	主食	其他主食	
素三鲜凉面	凉面	主食	面	凉面
素三鲜木耳大头菜	其他包子	主食	包子	其他包子
素三鲜焖面	焖面	主食	面	焖面
素丸子溜白菜	热菜	菜品	热菜	
素丸子烩白菜	热菜	菜品	热菜	
素丸子烩菜	热菜	菜品	热菜	
素交冷拌面	拌面	主食	面	拌面
素什锦冷面	凉面	主食	面	凉面
素什锦凉面	凉面	主食	面	凉面
素什锦汤面	汤面	主食	面	汤面
素什锦炒菜	热菜	菜品	热菜	
素什锦炒面	炒面	主食	面	炒面
素什锦盖浇饭	盖浇饭	主食	饭	盖浇饭
素加素拼盒饭	其他饭	主食	饭	其他饭
素拌赠米饭	其他菜品	其他	其他菜品	
素拍黄瓜小份菜	凉菜	菜品	凉菜	
素拼凉拌菜	凉菜	菜品	凉菜	
素拼小份凉菜	凉菜	菜品	凉菜	
素拼小凉菜	凉菜	菜品	凉菜	
素方盘拌菜	凉菜	菜品	凉菜	
素炒不烂子	热菜	菜品	热菜	
素炒刀削面	其他面	主食	面	其他面
素炒四季豆	热菜	菜品	热菜	
素炒圆包菜	热菜	菜品	热菜	
素炒圆白菜	热菜	菜品	热菜	
素炒土豆丝	热菜	菜品	热菜	
素炒土豆丝大	热菜	菜品	热菜	
素炒土豆丝盖浇饭	盖浇饭	主食	饭	盖浇饭
素炒土豆丸子	热菜	菜品	热菜	
素炒土豆片	热菜	菜品	热菜	
素炒大杂烩	热菜	菜品	热菜	
素炒娃娃菜	热菜	菜品	热菜	
素炒小木耳	热菜	菜品	热菜	
素炒小白菜	热菜	菜品	热菜	
素炒小青菜	热菜	菜品	热菜	
素炒山药盖浇饭	盖浇饭	主食	饭	盖浇饭
素炒干豆腐	热菜	菜品	热菜	
素炒拨烂子	炒面	主食	面	炒面
素炒有机菜花	热菜	菜品	热菜	
素炒杏鲍菇	热菜	菜品	热菜	
素炒毛白菜	热菜	菜品	热菜	
素炒油菜花	热菜	菜品	热菜	
素炒油麦菜	热菜	菜品	热菜	
素炒洋丝瓜	热菜	菜品	热菜	
素炒洋芋叉叉	热菜	菜品	热菜	
素炒洋葱豆腐卷	热菜	菜品	热菜	
素炒湘莴笋	热菜	菜品	热菜	
素炒白花菜	热菜	菜品	热菜	
素炒碱水面	炒面	主食	面	炒面
素炒空心菜	热菜	菜品	热菜	
素炒笨豆芽	热菜	菜品	热菜	
素炒绿豆芽	热菜	菜品	热菜	
素炒胡萝卜	热菜	菜品	热菜	
素炒胡萝卜丝	热菜	菜品	热菜	
素炒茄子丝	热菜	菜品	热菜	
素炒荷兰豆	热菜	菜品	热菜	
素炒莜面窝窝	炒面	主食	面	炒面
素炒莜面鱼	炒面	主食	面	炒面
素炒葫芦瓜	热菜	菜品	热菜	
素炒西兰花	热菜	菜品	热菜	
素炒西蓝花	热菜	菜品	热菜	
素炒豆腐菜	热菜	菜品	热菜	
素炒豆芽小炒	热菜	菜品	热菜	
素炒酱香双拼炒	米线	菜品	粉	米线
素炒酸菜粉	热菜	菜品	热菜	
素炒野木耳	热菜	菜品	热菜	
素炒长豆角	热菜	菜品	热菜	
素炒青油菜	热菜	菜品	热菜	
素炒鲜河粉	其他粉	主食	粉	其他粉
素烧茄子盖浇饭	盖浇饭	主食	饭	盖浇饭
素烧茄子盖饭	盖浇饭	主食	饭	盖浇饭
素烧茄子饭	盖浇饭	主食	饭	盖浇饭
素烩汤小份菜	汤羹	菜品	汤羹	
素独面筋盖饭	盖浇饭	主食	饭	盖浇饭
素番茄炒蛋	热菜	菜品	热菜	
素白面疙瘩汤	汤羹	菜品	汤羹	
素肠炒莴笋	热菜	菜品	热菜	
素茄子丝盖饭	盖浇饭	主食	饭	盖浇饭
素茭雪菜面	汤面	主食	面	汤面
素菜丸子汤	汤羹	菜品	汤羹	
素菜刀削面	其他面	主食	面	其他面
素菜套餐饭	其他菜品	其他	其他菜品	
素菜炒米粉	米线	主食	粉	米线
素菠菜臊子汤面	汤面	主食	面	汤面
素食紫光大拌菜	凉菜	菜品	凉菜	
素馅小白菜	其他包子	主食	包子	其他包子
素鸡兰花干面	盖浇面	主食	面	盖浇面
素鸡干丝汤	汤羹	菜品	汤羹	
素鸡炒芹菜木耳	热菜	菜品	热菜	
素鸡炒韭菜	热菜	菜品	热菜	
素鸡蛋炒莜面	炒面	主食	面	炒面
紫圆葱丝香菜	凉菜	菜品	凉菜	
紫米八宝粥	粥	主食	粥	
紫米冰糖稀饭	粥	主食	粥	
紫米桂花粥	粥	主食	粥	
紫米甜味粥	粥	主食	粥	
紫米红豆粥	粥	主食	粥	
紫米肉松紫菜包饭	寿司	主食	寿司	
紫米莲子粥	粥	主食	粥	
紫芋百合粥	粥	主食	粥	
紫苏炒黄瓜	热菜	菜品	热菜	
紫菜杂锦汤	汤羹	菜品	汤羹	
紫菜柿子蛋汤	汤羹	菜品	汤羹	
紫菜海米汤	汤羹	菜品	汤羹	
紫菜海蛎汤	汤羹	菜品	汤羹	
紫菜猪粉汤	米线	主食	粉	米线
紫菜瓜片蛋汤	汤羹	菜品	汤羹	
紫菜瓜片蛋花汤	汤羹	菜品	汤羹	
紫菜疙瘩汤	汤羹	菜品	汤羹	
紫菜瘦肉汤	汤羹	菜品	汤羹	
紫菜瘦肉粥	粥	主食	粥	
紫菜竹荪汤	汤羹	菜品	汤羹	
紫菜粉丝汤	其他粉	主食	粉	其他粉
紫菜肉丝鸡蛋汤	汤羹	菜品	汤羹	
紫菜肉片汤	汤羹	菜品	汤羹	
紫菜肉碎粥	粥	主食	粥	
紫菜胡啦蛋花汤	汤羹	菜品	汤羹	
紫菜芙蓉汤	汤羹	菜品	汤羹	
紫菜葱花汤	汤羹	菜品	汤羹	
紫菜虾仁廋肉粥	粥	主食	粥	
紫菜虾皮汤	汤羹	菜品	汤羹	
紫菜虾皮疙瘩汤	汤羹	菜品	汤羹	
紫菜虾皮蛋丝汤	汤羹	菜品	汤羹	
紫菜虾皮蛋汤	汤羹	菜品	汤羹	
紫菜虾皮蛋花汤	汤羹	菜品	汤羹	
紫菜虾皮鸡蛋汤	汤羹	菜品	汤羹	
紫菜虾米汤	汤羹	菜品	汤羹	
紫菜蛋丝汤	汤羹	菜品	汤羹	
紫菜蛋汤汤	汤羹	菜品	汤羹	
紫菜蛋皮汤	汤羹	菜品	汤羹	
紫菜蛋花儿汤	汤羹	菜品	汤羹	
紫菜蛋花汤	粥	菜品	粥	
紫菜蛋花粥	粥	主食	粥	
紫菜蛋花豆腐汤	汤羹	菜品	汤羹	
紫菜蛋花速食汤	汤羹	菜品	汤羹	
紫菜豆腐汤	汤羹	菜品	汤羹	
紫菜酸汤面	汤面	主食	面	汤面
紫菜香菜鱼丸汤	汤羹	菜品	汤羹	
紫菜鱼丸汤	汤羹	菜品	汤羹	
紫菜鱼片粥	粥	主食	粥	
紫菜鲜虾粥	粥	主食	粥	
紫菜鸡蛋汤	汤羹	菜品	汤羹	
紫菜鸡蛋疙瘩汤	汤羹	菜品	汤羹	
紫菜鸡蛋芙蓉汤	汤羹	菜品	汤羹	
紫菜鸡蛋虾皮粥	粥	主食	粥	
紫菜鸡蛋黄瓜丝汤	汤羹	菜品	汤羹	
紫菜黄瓜汤	汤羹	菜品	汤羹	
紫菜黄瓜西红柿蛋花汤	汤羹	菜品	汤羹	
紫薯八宝粥	粥	主食	粥	
紫薯地瓜米粥	粥	主食	粥	
紫薯山药粥	粥	主食	粥	
紫薯杂粮粥	粥	主食	粥	
紫薯栗子粥	粥	主食	粥	
紫薯燕麦粥	粥	主食	粥	
紫薯玉米饭	白米饭	主食	饭	白米饭
紫薯薏米粥	粥	主食	粥	
紫薯黑米粥	粥	主食	粥	
红小豆小碴粥	粥	主食	粥	
红枣乌鸡汤	汤羹	菜品	汤羹	
红枣元肉炖鸡蛋	热菜	菜品	热菜	
红枣党参炖鸡	汤羹	菜品	汤羹	
红枣八宝粥	粥	主食	粥	
红枣养胃粥	粥	主食	粥	
红枣养颜甜粥	粥	主食	粥	
红枣冰糖粥	粥	主食	粥	
红枣冰糖银耳汤	糖水/炖品	甜点	糖水/炖品	
红枣南瓜汤	汤羹	菜品	汤羹	
红枣南瓜粥	粥	主食	粥	
红枣南瓜银耳汤	糖水/炖品	甜点	糖水/炖品	
红枣土鸡汤	汤羹	菜品	汤羹	
红枣大麦粥	粥	主食	粥	
红枣奶香燕麦粥	粥	主食	粥	
红枣小米南瓜粥	粥	主食	粥	
红枣小米粥	粥	主食	粥	
红枣小米红糖南瓜粥	粥	主食	粥	
红枣山药乌鸡汤	汤羹	菜品	汤羹	
红枣山药土鸡汤	汤羹	菜品	汤羹	
红枣山药大麦粥	粥	主食	粥	
红枣山药小米粥	粥	主食	粥	
红枣山药枸杞粥	粥	主食	粥	
红枣山药粥	粥	主食	粥	
红枣木耳汤	糖水/炖品	甜点	糖水/炖品	
红枣板栗粥	粥	主食	粥	
红枣枸杞乌鸡汤	汤羹	菜品	汤羹	
红枣枸杞养胃粥	粥	主食	粥	
红枣枸杞小米粥	粥	主食	粥	
红枣枸杞粥	粥	主食	粥	
红枣枸杞红糖粥	粥	主食	粥	
红枣枸杞银耳汤	糖水/炖品	甜点	糖水/炖品	
红枣栗子粥	粥	主食	粥	
红枣核桃粥	粥	主食	粥	
红枣核桃花生粥	粥	主食	粥	
红枣桂圆乌鸡汤	汤羹	菜品	汤羹	
红枣桂圆杂粮粥	粥	主食	粥	
红枣桂圆枸杞粥	粥	主食	粥	
红枣桂圆汤	糖水/炖品	甜点	糖水/炖品	
红枣桂圆炖蛋	糖水/炖品	甜点	糖水/炖品	
红枣桂圆燕麦粥	粥	主食	粥	
红枣桂圆粥	粥	主食	粥	
红枣桂圆莲子粥	粥	主食	粥	
红枣桂圆葡糖干粥	粥	主食	粥	
红枣桂圆葡萄粥	粥	主食	粥	
红枣桂圆蛋汤	糖水/炖品	甜点	糖水/炖品	
红枣桂圆银耳粥	粥	主食	粥	
红枣桂圆黑米粥	粥	主食	粥	
红枣椰奶燕麦粥	粥	主食	粥	
红枣灰豆汤	汤羹	菜品	汤羹	
红枣炖乌鸡汤	汤羹	菜品	汤羹	
红枣炖鹆子汤	汤羹	菜品	汤羹	
红枣燕麦粥	粥	主食	粥	
红枣燕麦荷叶粥	粥	主食	粥	
红枣牛奶粥	粥	主食	粥	
红枣白鸽汤	汤羹	菜品	汤羹	
红枣百合粥	粥	主食	粥	
红枣粥燕麦粥	粥	主食	粥	
红枣糯米粥	粥	主食	粥	
红枣糯米莲子粥	粥	主食	粥	
红枣红糖小米粥	粥	主食	粥	
红枣红豆元宵粥	粥	主食	粥	
红枣红豆粥	粥	主食	粥	
红枣绿豆汤	糖水/炖品	甜点	糖水/炖品	
红枣绿豆黑米粥	粥	主食	粥	
红枣老鸡汤	汤羹	菜品	汤羹	
红枣肚片汤	汤羹	菜品	汤羹	
红枣花生牛奶粥	粥	主食	粥	
红枣花生葡萄粥	粥	主食	粥	
红枣苹果姜汤	其他甜品	甜点	其他甜品	
红枣草鸡汤	汤羹	菜品	汤羹	
红枣荷叶粥	粥	主食	粥	
红枣莲子乌鸡汤	汤羹	菜品	汤羹	
红枣莲子粥	粥	主食	粥	
红枣莲子银耳汤	汤羹	菜品	汤羹	
红枣莲藕粥	粥	主食	粥	
红枣补血养颜粥	粥	主食	粥	
红枣补血粥	粥	主食	粥	
红枣连子汤	糖水/炖品	甜点	糖水/炖品	
红枣银耳南瓜汤	汤羹	菜品	汤羹	
红枣银耳枸杞汤	糖水/炖品	甜点	糖水/炖品	
红枣银耳枸杞粥	粥	主食	粥	
红枣银耳汤	糖水/炖品	菜品	糖水/炖品	
红枣银耳百合粥	粥	主食	粥	
红枣银耳粥	粥	主食	粥	
红枣银耳莲子汤	糖水/炖品	甜点	糖水/炖品	
红枣雪耳汤	糖水/炖品	甜点	糖水/炖品	
红枣黑米粥	粥	主食	粥	
红烧土豆牛肉饭	盖浇饭	主食	饭	盖浇饭
红烧土豆饭	盖浇饭	主食	饭	盖浇饭
红烧大白菜	热菜	菜品	热菜	
红烧瘦肉面	汤面	主食	面	汤面
红烧茄子不配饭	热菜	菜品	热菜	
红烧茄子丨小下饭	热菜	菜品	热菜	
红烧茄子盖浇含米饭	盖浇饭	主食	饭	盖浇饭
红烧茄子盖浇米饭	盖浇饭	主食	饭	盖浇饭
红烧茄子饭	盖浇饭	主食	饭	盖浇饭
红烧豆腐炒菜	热菜	菜品	热菜	
红烧豆腐盖浇饭	盖浇饭	主食	饭	盖浇饭
红烧豆腐盖饭	盖浇饭	主食	饭	盖浇饭
红烧豆腐面	盖浇面	主食	面	盖浇面
红烧豆腐饭	盖浇饭	主食	饭	盖浇饭
红烧鱼块小碗菜	热菜	菜品	热菜	
红烧鳕鱼小份菜	热菜	菜品	热菜	
红烧鳕鱼小碗菜	热菜	菜品	热菜	
红焖黄花鱼饭	其他饭	主食	饭	其他饭
红片麦仁粥	粥	主食	粥	
红福大拌菜	凉菜	菜品	凉菜	
红糖八宝粥	粥	主食	粥	
红糖养胃小米粥	粥	主食	粥	
红糖南瓜补气粥	粥	主食	粥	
红糖南瓜补血粥	粥	主食	粥	
红糖大枣八宝粥	粥	主食	粥	
红糖大枣小米粥	粥	主食	粥	
红糖大枣枸杞粥	粥	主食	粥	
红糖大枣粥	粥	主食	粥	
红糖小米南瓜枸杞粥	粥	主食	粥	
红糖小米粥	粥	主食	粥	
红糖山药小米粥	粥	主食	粥	
红糖山药粥	粥	主食	粥	
红糖燕麦小米粥	粥	主食	粥	
红糖燕麦枸杞红枣粥	粥	主食	粥	
红糖燕麦粥	粥	主食	粥	
红糖红枣枸杞粥	粥	主食	粥	
红糖红枣枸杞补血粥	粥	主食	粥	
红糖红枣粥	粥	主食	粥	
红糖红枣蔓越莓粥	粥	主食	粥	
红糖红豆粥	粥	主食	粥	
红糖红豆红枣粥	粥	主食	粥	
红糖红豆薏米粥	粥	主食	粥	
红糖银耳雪梨粥	粥	主食	粥	
红糖黑米粥	粥	主食	粥	
红绿双豆粥	粥	主食	粥	
红罗卜炒肉	热菜	菜品	热菜	
红芋干稀饭	粥	主食	粥	
红芋片稀饭	粥	主食	粥	
红花小米粥	粥	主食	粥	
红萝卜丝炒肉丝	热菜	菜品	热菜	
红萝卜炒粉条	热菜	菜品	热菜	
红萝卜炒肉	热菜	菜品	热菜	
红萝卜炒肉木桶饭	木桶饭	主食	饭	木桶饭
红萝卜炒蛋	热菜	菜品	热菜	
红萝卜炖羊肉	热菜	菜品	热菜	
红萝卜玉米排骨汤	汤羹	菜品	汤羹	
红葱鸡蛋炒饭	炒饭	主食	饭	炒饭
红薯南瓜粥	粥	主食	粥	
红薯叶炒鲜小笋	热菜	菜品	热菜	
红薯小米白粥	粥	主食	粥	
红薯小米粥	粥	主食	粥	
红薯干稀饭	粥	主食	粥	
红薯棒碴粥	粥	主食	粥	
红薯片稀饭	粥	主食	粥	
红薯百合粥	粥	主食	粥	
红薯粉条炖牛肋条	热菜	菜品	热菜	
红薯粉烧包菜	热菜	菜品	热菜	
红薯糯米粥	粥	主食	粥	
红蘑炒土豆片	热菜	菜品	热菜	
红谷小米粥	粥	主食	粥	
红谷纯小米粥	粥	主食	粥	
红豆八宝粥	粥	主食	粥	
红豆养生粥	粥	主食	粥	
红豆南瓜粥	粥	主食	粥	
红豆圆子粥	粥	主食	粥	
红豆大枣粥	粥	主食	粥	
红豆大米粥	粥	主食	粥	
红豆小米稀饭	粥	主食	粥	
红豆小米粥	粥	主食	粥	
红豆山药粥	粥	主食	粥	
红豆杂粮粥	粥	主食	粥	
红豆板栗粥	粥	主食	粥	
红豆江米稀饭	粥	主食	粥	
红豆江米粥	粥	主食	粥	
红豆燕麦汤	糖水/炖品	甜点	糖水/炖品	
红豆燕麦红糖粥	粥	主食	粥	
红豆玉米粥	粥	主食	粥	
红豆糯米莲子汤	糖水/炖品	甜点	糖水/炖品	
红豆紫米粥	粥	主食	粥	
红豆红枣桂圆汤汤	糖水/炖品	甜点	糖水/炖品	
红豆红枣汤	糖水/炖品	甜点	糖水/炖品	
红豆红枣粥	粥	主食	粥	
红豆红枣红糖粥	粥	主食	粥	
红豆红枣芋圆粥	粥	主食	粥	
红豆红枣补血粥	粥	主食	粥	
红豆红糖粥	粥	主食	粥	
红豆花生大枣粥	粥	主食	粥	
红豆花生汤	糖水/炖品	甜点	糖水/炖品	
红豆花生稀饭	粥	主食	粥	
红豆花生粥	粥	主食	粥	
红豆花生糯米粥	粥	主食	粥	
红豆花生黑米粥	粥	主食	粥	
红豆莲子汤	糖水/炖品	甜点	糖水/炖品	
红豆莲子粥	汤羹	菜品	汤羹	
红豆薏仁米汤	糖水/炖品	甜点	糖水/炖品	
红豆薏仁米粥	粥	主食	粥	
红豆薏仁粥	粥	主食	粥	
红豆薏仁美肤粥	粥	主食	粥	
红豆薏米去湿粥	粥	主食	粥	
红豆薏米汤	糖水/炖品	甜点	糖水/炖品	
红豆薏米粥	粥	菜品	粥	
红豆薏米红枣粥	粥	主食	粥	
红豆薏米美肤粥	粥	主食	粥	
红豆蜜枣粥	粥	主食	粥	
红豆银耳汤	糖水/炖品	甜点	糖水/炖品	
红豆降糖粥	粥	主食	粥	
红豆麦仁稀饭	粥	主食	粥	
红豆麦仁粥	粥	主食	粥	
红豆黑米粥	粥	主食	粥	
红豆黑米血糯粥	粥	主食	粥	
纯东北二米饭	白米饭	主食	饭	白米饭
纯五常稻花香米饭	白米饭	主食	饭	白米饭
纯净水现压荞麦冷面	凉面	主食	面	凉面
纯小笨鸡炖蘑菇	热菜	菜品	热菜	
纯小米南瓜粥	粥	主食	粥	
纯手工拖刀面	手擀面	主食	面	手擀面
纯手工炒刀削	其他面	主食	面	其他面
纯手工菠菜面	拌面	主食	面	拌面
纯手工萝卜泡菜	凉菜	菜品	凉菜	
纯粮南瓜粥	粥	主食	粥	
纯粹鸡蛋汤	汤羹	菜品	汤羹	
纯素时蔬炒米粉	米线	主食	粉	米线
纯素胡辣汤	汤羹	菜品	汤羹	
纯素豆角焖面	焖面	主食	面	焖面
纯纯元气小米枸杞粥	粥	主食	粥	
纯香无糖紫米粥	粥	主食	粥	
纸薄笋炒肉	热菜	菜品	热菜	
线椒炒土鸡蛋	热菜	菜品	热菜	
线椒炒鸡蛋	热菜	菜品	热菜	
细木耳炖罐	汤羹	菜品	汤羹	
细黄面饸饹面	汤面	主食	面	汤面
经典全素凉面	凉面	主食	面	凉面
经典八宝粥	粥	主食	粥	
经典古法白粥	粥	主食	粥	
经典大拌菜	凉菜	菜品	凉菜	
经典扁豆焖面	焖面	主食	面	焖面
经典拌合菜	凉菜	菜品	凉菜	
经典拌花菜	凉菜	菜品	凉菜	
经典清鸡汤面	汤面	主食	面	汤面
经典现煮鱼片粥	粥	主食	粥	
经典番茄意大利面	意大利面	主食	面	意大利面
经典番茄意面	意大利面	主食	面	意大利面
经典番茄牛肉面	汤面	主食	面	汤面
经典皮蛋瘦肉粥	粥	主食	粥	
经典砂锅粥	粥	主食	粥	
经典粥品中华八宝粥	粥	主食	粥	
经典素炒米粉	米线	主食	粉	米线
经典老厨白菜	热菜	菜品	热菜	
经典老鸭粉丝汤	其他粉	主食	粉	其他粉
经典莲藕汤	汤羹	菜品	汤羹	
经典西红柿打卤面	盖浇面	主食	面	盖浇面
经典西红柿蛋汤	汤羹	菜品	汤羹	
经典西红柿鸡蛋面	汤面	主食	面	汤面
经典豆角焖面	焖面	主食	面	焖面
绝味裙带菜	凉菜	菜品	凉菜	
绵绵绿豆粥	粥	主食	粥	
绵绵血糯粥	粥	主食	粥	
综合紫菜包饭	其他饭	主食	饭	其他饭
综合紫菜饭	寿司	主食	寿司	
绿甘兰鸡蛋炒馒头	炒面	主食	面	炒面
绿甘蓝炒粉丝	米线	主食	粉	米线
绿色小青菜	浇头	其他	浇头	
绿色时令蔬菜	热菜	菜品	热菜	
绿色稻鸭米饭	白米饭	主食	饭	白米饭
绿色蔬菜粥	粥	主食	粥	
绿色蔬菜面	其他菜品	其他	其他菜品	
绿色青菜粥	粥	主食	粥	
绿茶小炒藕片	热菜	菜品	热菜	
绿豆八宝汤	糖水/炖品	甜点	糖水/炖品	
绿豆冰糖莲子粥	粥	主食	粥	
绿豆南瓜汤	汤羹	菜品	汤羹	
绿豆南瓜粥	粥	主食	粥	
绿豆大米粥	粥	主食	粥	
绿豆小米汤	粥	主食	粥	
绿豆小米粥	粥	主食	粥	
绿豆排骨汤	汤羹	菜品	汤羹	
绿豆玉米粥	粥	主食	粥	
绿豆百合汤	糖水/炖品	甜点	糖水/炖品	
绿豆百合粥	粥	菜品	粥	
绿豆粥百合粥	汤羹	菜品	汤羹	
绿豆糯米粥	粥	主食	粥	
绿豆红枣汤	糖水/炖品	甜点	糖水/炖品	
绿豆芋圆汤	其他甜品	甜点	其他甜品	
绿豆芽加主食一起炒	热菜	菜品	热菜	
绿豆芽小炒	热菜	菜品	热菜	
绿豆芽抄韭菜	热菜	菜品	热菜	
绿豆芽炒粉	热菜	菜品	热菜	
绿豆芽炒粉小	热菜	菜品	热菜	
绿豆芽炒粉条	热菜	菜品	热菜	
绿豆芽炒粉盘菜	热菜	菜品	热菜	
绿豆芽炒肉	热菜	菜品	热菜	
绿豆芽炒肉丝	热菜	菜品	热菜	
绿豆芽炒腐竹	热菜	菜品	热菜	
绿豆芽炒面皮	凉皮	主食	凉皮	
绿豆芽炒韭菜	热菜	菜品	热菜	
绿豆芽炒饼	热菜	菜品	热菜	
绿豆芽蛋炒饼	其他主食	主食	其他主食	
绿豆芽雪菜	热菜	菜品	热菜	
绿豆芽韭菜	热菜	菜品	热菜	
绿豆莲子汤	糖水/炖品	甜点	糖水/炖品	
绿豆莲子燕麦粥	粥	主食	粥	
绿豆莲子粥	粥	主食	粥	
绿豆莲子红枣粥	粥	主食	粥	
绿豆薏仁汤	糖水/炖品	菜品	糖水/炖品	
绿豆薏米粥	粥	主食	粥	
绿豆西米汤	其他甜品	甜点	其他甜品	
绿豆解暑粥	粥	主食	粥	
绿豆豆沙粥	粥	主食	粥	
绿豆银耳枸杞粥	粥	主食	粥	
绿豆银耳粥	粥	主食	粥	
绿豆面丸子汤	汤羹	菜品	汤羹	
绿豆面面汤	汤面	主食	面	汤面
绿豆香米粥	粥	主食	粥	
绿豆麦仁稀饭	粥	主食	粥	
缤纷大拌菜	凉菜	菜品	凉菜	
缤纷红薯粥	粥	主食	粥	
缸豆炒肉丝	热菜	菜品	热菜	
罐装汪集老鸭汤	汤羹	菜品	汤羹	
罗卜丝炒肉丝	热菜	菜品	热菜	
罗卜丸子汤	汤羹	菜品	汤羹	
罗卜丸子骨头汤	汤羹	菜品	汤羹	
罗卜干炒蛋	热菜	菜品	热菜	
罗汉上素焖手擀面	手擀面	主食	面	手擀面
罗汉笋丨低卡素菜	蔬菜类	火锅/串串/麻辣烫/色拉自选	配菜	蔬菜类
罗汉素浇冷拌面	凉面	主食	面	凉面
罗汉素浇煨面	盖浇面	主食	面	盖浇面
罗马生菜清炒	热菜	菜品	热菜	
羊丸萝卜汤	汤羹	菜品	汤羹	
羊排山药滋补汤	汤羹	菜品	汤羹	
羊肉小白菜	热菜	菜品	热菜	
羊肉小米粥	粥	主食	粥	
羊肉汤清汤	汤羹	菜品	汤羹	
羊肉炒芹菜	热菜	菜品	热菜	
羊肉炖山药	热菜	菜品	热菜	
羊肉炖豆腐	热菜	菜品	热菜	
羊肉片儿汤	汤羹	菜品	汤羹	
羊肉粉丝千张白菜	其他粉	主食	粉	其他粉
羊肉萝卜汤	汤羹	菜品	汤羹	
羊肚菌乌鸡汤	汤羹	菜品	汤羹	
羊肚菌小炒鲜鲍鱼	热菜	菜品	热菜	
羊肚菌山药排骨汤	汤羹	菜品	汤羹	
羊肚菌炖瑶柱	热菜	菜品	热菜	
羊肚菌竹荪汤	汤羹	菜品	汤羹	
羊肚菌虾滑炒芦笋	热菜	菜品	热菜	
羊肝拌菠菜	凉菜	菜品	凉菜	
羊血炖豆腐	热菜	菜品	热菜	
美味丝瓜炒蛋	热菜	菜品	热菜	
美味二米粥	粥	主食	粥	
美味八宝粥	粥	主食	粥	
美味南瓜粥	粥	主食	粥	
美味叶子菜	热菜	菜品	热菜	
美味大拌菜	凉菜	菜品	凉菜	
美味小米粥	粥	主食	粥	
美味手撕包菜	热菜	菜品	热菜	
美味明虾粥	粥	主食	粥	
美味杂菇汤	汤羹	菜品	汤羹	
美味炒合菜	热菜	菜品	热菜	
美味炒土豆丝	热菜	菜品	热菜	
美味牛骨清汤	汤羹	菜品	汤羹	
美味疙瘩汤	汤羹	菜品	汤羹	
美味白虾粥	粥	主食	粥	
美味的青菜肉丝汤面	汤面	主食	面	汤面
美味粉丝汤	其他粉	主食	粉	其他粉
美味紫菜蛋花汤	汤羹	菜品	汤羹	
美味红豆粥	粥	主食	粥	
美味腊八粥	粥	主食	粥	
美味萝卜汤	汤羹	菜品	汤羹	
美味营养米饭	白米饭	主食	饭	白米饭
美味蛋炒饭	炒饭	主食	饭	炒饭
美味裙带菜	凉菜	菜品	凉菜	
美味豆腐汤	汤羹	菜品	汤羹	
美味豆芽菜	热菜	菜品	热菜	
美味酱炖豆腐	热菜	菜品	热菜	
美味酸辣汤	汤羹	菜品	汤羹	
美味青菜炒蘑菇	热菜	菜品	热菜	
美味鲜虾粥	粥	主食	粥	
美味鸡丝粥	粥	主食	粥	
美味鸡蛋汤	汤羹	菜品	汤羹	
美味黑鱼面	汤面	主食	面	汤面
美容养颜粥	粥	主食	粥	
美容南瓜粥	粥	主食	粥	
美极大拌菜	凉菜	菜品	凉菜	
美极娃娃菜	热菜	菜品	热菜	
美颜八宝粥	粥	主食	粥	
美颜红豆粥	粥	主食	粥	
羽衣甘蓝蔬菜汤	汤羹	菜品	汤羹	
翅汤娃娃菜	热菜	菜品	热菜	
翠绿小菠菜	蔬菜类	火锅/串串/麻辣烫/色拉自选	配菜	蔬菜类
翠绿翠绿的小白菜	热菜	菜品	热菜	
翠花上酸菜	热菜	菜品	热菜	
翡翠大份大头菜	蔬菜类	烧烤	蔬菜类	
翡翠大白菜	蔬菜类	火锅/串串/麻辣烫/色拉自选	配菜	蔬菜类
翡翠珍珠汤	汤羹	菜品	汤羹	
翡翠绿豆粥	粥	主食	粥	
翡翠虾仁炒山药	热菜	菜品	热菜	
老上海单档汤	汤羹	菜品	汤羹	
老上海双档汤	汤羹	菜品	汤羹	
老上海菜饭	炒饭	主食	饭	炒饭
老东北大拌菜	凉菜	菜品	凉菜	
老东北疙瘩汤	汤羹	菜品	汤羹	
老保定碗菜	凉菜	菜品	凉菜	
老兰州烩菜	热菜	菜品	热菜	
老冯家大烩菜	热菜	菜品	热菜	
老北京打卤面	盖浇面	其他	面	盖浇面
老北京炒合菜	热菜	菜品	热菜	
老北京炒红果儿	其他甜品	甜点	其他甜品	
老北京炖带鱼	热菜	菜品	热菜	
老北京炙子素烤面	拌面	主食	面	拌面
老北京烫饭	泡饭	主食	饭	泡饭
老北京疙瘩汤	汤羹	菜品	汤羹	
老北京素油炒麻豆腐	热菜	菜品	热菜	
老北京素炒疙瘩	炒面	主食	面	炒面
老北京豆泡汤	汤羹	菜品	汤羹	
老北京醋溜白菜	热菜	菜品	热菜	
老北京风味疙瘩汤	汤羹	菜品	汤羹	
老北京鸡蛋炒饼	其他主食	主食	其他主食	
老卤素鸡面	汤面	主食	面	汤面
老厨烧白菜	热菜	菜品	热菜	
老味儿粉汤	其他粉	主食	粉	其他粉
老味小锅炖牛肉	热菜	菜品	热菜	
老味炖干豆腐	热菜	菜品	热菜	
老味萝卜丸子汤	汤羹	菜品	汤羹	
老味酥肉炖白菜	热菜	菜品	热菜	
老味香菇油菜	热菜	菜品	热菜	
老善大烩菜	热菜	菜品	热菜	
老坛菜炒蛋	热菜	菜品	热菜	
老大同黄花烩菜	热菜	菜品	热菜	
老太太疙瘩汤	汤羹	菜品	汤羹	
老头儿茭白小炒	热菜	菜品	热菜	
老妈土豆丝饭	盖浇饭	主食	饭	盖浇饭
老妈妈湘西外婆菜	热菜	菜品	热菜	
老妈拿手菜	热菜	菜品	热菜	
老妈炒圆白菜	热菜	菜品	热菜	
老妈炒粉丝	热菜	菜品	热菜	
老妈炒肉末酸菜粉丝	其他粉	主食	粉	其他粉
老妈炖带鱼	热菜	菜品	热菜	
老妈炖豆角	热菜	菜品	热菜	
老妈疙瘩汤	汤羹	菜品	汤羹	
老妈菜炒鸡蛋	热菜	菜品	热菜	
老妈葱油罗马生菜	热菜	菜品	热菜	
老妈蚬子面	汤面	主食	面	汤面
老妈西红柿炒鸡蛋	热菜	菜品	热菜	
老姜汁汤面	汤面	主食	面	汤面
老姜肉片汤	汤羹	菜品	汤羹	
老家疙瘩汤	汤羹	菜品	汤羹	
老家酸汤面	汤面	主食	面	汤面
老山西烩菜	热菜	菜品	热菜	
老常州豆腐汤	汤羹	菜品	汤羹	
老干部招待菜	热菜	菜品	热菜	
老底子番薯粥	粥	主食	粥	
老式八宝粥	粥	主食	粥	
老式刀削面	其他面	主食	面	其他面
老式清炒肉	热菜	菜品	热菜	
老式蛋炒饭	炒饭	主食	饭	炒饭
老式酸辣汤	汤羹	菜品	汤羹	
老式鸡蛋汤	汤羹	菜品	汤羹	
老当湖养生小炒	热菜	菜品	热菜	
老手艺丸子汤	汤羹	菜品	汤羹	
老本打烩菜	热菜	菜品	热菜	
老板加一份拌菜	凉菜	菜品	凉菜	
老板加份小白菜	浇头	其他	浇头	
老板来点小青菜	浇头	其他	浇头	
老板鱼炖豆腐	热菜	菜品	热菜	
老母鸡炖红蘑粉条	热菜	菜品	热菜	
老母鸡烂面	汤面	主食	面	汤面
老母鸡蛋汤	汤羹	菜品	汤羹	
老汤冬瓜菠菜	汤羹	菜品	汤羹	
老汤干豆腐饭	泡饭	主食	饭	泡饭
老汤炖土豆	热菜	菜品	热菜	
老汤炖土豆白菜双拼	热菜	菜品	热菜	
老汤炖豆泡儿	热菜	菜品	热菜	
老汤炖豆腐	热菜	菜品	热菜	
老汤茄子饭	盖浇饭	主食	饭	盖浇饭
老汤葱花面	汤面	主食	面	汤面
老汤青菜肉丝面	汤面	主食	面	汤面
老津味西红柿鸡蛋面	其他菜品	其他	其他菜品	
老济南炒合菜	热菜	菜品	热菜	
老济南炒焖饼	其他主食	主食	其他主食	
老港口皮蛋瘦肉粥	粥	主食	粥	
老滕县特色白粥	粥	主食	粥	
老满大拌菜	凉菜	菜品	凉菜	
老潍县咸粥	粥	主食	粥	
老火清香白米粥	粥	主食	粥	
老火炖冬瓜	热菜	菜品	热菜	
老火煨藕汤	汤羹	菜品	汤羹	
老火猪肺萝卜汤	汤羹	菜品	汤羹	
老火生滚牛肉粥	粥	主食	粥	
老火白米粥	粥	主食	粥	
老火皮蛋瘦肉粥	粥	主食	粥	
老火菜干汤	汤羹	菜品	汤羹	
老火靓白粥	粥	主食	粥	
老牌三鲜粥	粥	主食	粥	
老狼疙瘩汤	汤羹	菜品	汤羹	
老白菜炖豆腐	热菜	菜品	热菜	
老稻田米饭	白米饭	主食	饭	白米饭
老肉炖豆腐	热菜	菜品	热菜	
老肉豆腐小白菜	热菜	菜品	热菜	
老胡同炖菜	热菜	菜品	热菜	
老舅拌菠菜	凉菜	菜品	凉菜	
老蚌埠炒木须	热菜	菜品	热菜	
老豆腐拉面	拉面	主食	面	拉面
老豆腐炒青菜	热菜	菜品	热菜	
老豆腐炖白菜	热菜	菜品	热菜	
老豆腐炖骨头	热菜	菜品	热菜	
老醋四样菜	凉菜	菜品	凉菜	
老醋果仁菠菜	热菜	菜品	热菜	
老醋里脊白菜	凉菜	菜品	凉菜	
老镇炒合菜	热菜	菜品	热菜	
老陕大烩菜	热菜	菜品	热菜	
老陕香菇面	汤面	主食	面	汤面
老院子小炒笨豆芽	热菜	菜品	热菜	
老青岛炒合菜	热菜	菜品	热菜	
老鸡蘑菇面	汤面	主食	面	汤面
老鸭东瓜汤	汤羹	菜品	汤羹	
老鸭汤乌冬面	乌冬面	主食	面	乌冬面
老鸭汤加面	汤面	主食	面	汤面
老鸭汤套餐饭	其他饭	主食	饭	其他饭
老鸭汤手擀面	手擀面	主食	面	手擀面
老鸭汤泡饭	泡饭	主食	饭	泡饭
老鸭汤饭菜	泡饭	主食	饭	泡饭
老鸭汤鸭肉面	汤面	主食	面	汤面
老鸭海带汤	汤羹	菜品	汤羹	
老鸭瓦罐汤	汤羹	菜品	汤羹	
老鸭粉丝汤	米线	主食	粉	米线
老鸭肚片汤	汤羹	菜品	汤羹	
老黄瓜柿子汤	汤羹	菜品	汤羹	
老黄瓜炒土豆片	热菜	菜品	热菜	
老黄瓜炒肉	热菜	菜品	热菜	
老黄瓜种炒虾仁	热菜	菜品	热菜	
老黄瓜蛋花汤	汤羹	菜品	汤羹	
老黄瓜鸡蛋柿子汤	汤羹	菜品	汤羹	
老黄瓜鸡蛋汤	汤羹	菜品	汤羹	
耗油圆生菜	热菜	菜品	热菜	
耗油西生菜	热菜	菜品	热菜	
耙耙菜青菜	热菜	菜品	热菜	
聚宝源拌菜	凉菜	菜品	凉菜	
聚福大拌菜	凉菜	菜品	凉菜	
肉丁炒黄瓜	热菜	菜品	热菜	
肉丁炒黄豆芽	热菜	菜品	热菜	
肉丁茄子面	盖浇面	主食	面	盖浇面
肉丝加鸡蛋炒豆皮	热菜	菜品	热菜	
肉丝大头菜	热菜	菜品	热菜	
肉丝娃娃菜	热菜	菜品	热菜	
肉丝尖椒炒笋干	热菜	菜品	热菜	
肉丝山野菜	热菜	菜品	热菜	
肉丝炒土豆丝	热菜	菜品	热菜	
肉丝炒土豆粉	热菜	菜品	热菜	
肉丝炒土鸡蛋	热菜	菜品	热菜	
肉丝炒小白菜粉条	热菜	菜品	热菜	
肉丝炒水芹	热菜	菜品	热菜	
肉丝炒泥蒿	热菜	菜品	热菜	
肉丝炒绿豆芽	热菜	菜品	热菜	
肉丝炒腐竹	热菜	菜品	热菜	
肉丝炒花菜	热菜	菜品	热菜	
肉丝炒芸豆	热菜	菜品	热菜	
肉丝炒芹菜	热菜	菜品	热菜	
肉丝炒茼蒿	热菜	菜品	热菜	
肉丝炒蒜苔	热菜	菜品	热菜	
肉丝炒蒜苗	热菜	菜品	热菜	
肉丝炒蒜黄	热菜	菜品	热菜	
肉丝炒豆芽	热菜	菜品	热菜	
肉丝炒豆芽粉	热菜	菜品	热菜	
肉丝炒豆角	热菜	菜品	热菜	
肉丝炒豆角丝	热菜	菜品	热菜	
肉丝炒香芹	热菜	菜品	热菜	
肉丝烂糊白菜	热菜	菜品	热菜	
肉丝疙瘩粥	粥	主食	粥	
肉丝白菜炒粉丝	热菜	菜品	热菜	
肉丝芹菜炒粉	热菜	菜品	热菜	
肉丝芹菜盖饭	盖浇饭	主食	饭	盖浇饭
肉丝茄子打卤面	盖浇面	主食	面	盖浇面
肉丝茄子豆角饭	盖浇饭	主食	饭	盖浇饭
肉丝茭白盖浇饭	盖浇饭	主食	饭	盖浇饭
肉丝菜汤面	汤面	主食	面	汤面
肉丝蔬菜炒饼	其他主食	主食	其他主食	
肉丝蔬菜疙瘩汤	汤羹	菜品	汤羹	
肉丝蛋花汤	汤羹	菜品	汤羹	
肉丝豆腐汤	汤羹	菜品	汤羹	
肉丝豆芽炒粉条	热菜	菜品	热菜	
肉丝豆芽菜	热菜	菜品	热菜	
肉丝青菜粥	粥	主食	粥	
肉丝青菜蛋汤	汤羹	菜品	汤羹	
肉丝香菇炒粉	米线	主食	粉	米线
肉丝鸡蛋汤	汤羹	菜品	汤羹	
肉丝鸡蛋炒饼	其他主食	主食	其他主食	
肉丝鸡蛋面	盖浇面	主食	面	盖浇面
肉丝黄瓜汤面	汤面	主食	面	汤面
肉丸三鲜汤	汤羹	菜品	汤羹	
肉丸子烘大白菜	热菜	菜品	热菜	
肉丸炒腐竹	热菜	菜品	热菜	
肉丸炖冬瓜	热菜	菜品	热菜	
肉丸炖白菜	热菜	菜品	热菜	
肉丸烧白菜	热菜	菜品	热菜	
肉丸蔬菜汤	汤羹	菜品	汤羹	
肉圆烧白菜	热菜	菜品	热菜	
肉圆青菜汤	汤羹	菜品	汤羹	
肉末包菜炒粉丝	热菜	菜品	热菜	
肉末小白菜	热菜	菜品	热菜	
肉末小白菜炒粉	热菜	菜品	热菜	
肉末小白菜炒粉条	热菜	菜品	热菜	
肉末杭白菜	热菜	菜品	热菜	
肉末梅干菜	其他包子	主食	包子	其他包子
肉末炒茄子	热菜	菜品	热菜	
肉末炖豆腐	热菜	菜品	热菜	
肉末粉丝小油菜	热菜	菜品	热菜	
肉末粉丝小白菜	热菜	菜品	热菜	
肉末粉条小油菜	热菜	菜品	热菜	
肉末芸豆打卤面	盖浇面	主食	面	盖浇面
肉末芹菜炒粉	热菜	菜品	热菜	
肉末茄丁面	盖浇面	主食	面	盖浇面
肉末茄子小份带米饭	其他菜品	其他	其他菜品	
肉末茄子小碗菜	热菜	菜品	热菜	
肉末茄子打卤面	盖浇面	主食	面	盖浇面
肉末茄子浇饭	盖浇饭	主食	饭	盖浇饭
肉末茄子炒菜	热菜	菜品	热菜	
肉末茄子盖浇饭	盖浇饭	主食	饭	盖浇饭
肉末茄子盖饭	盖浇饭	主食	饭	盖浇饭
肉末茄子饭	盖浇饭	其他	饭	盖浇饭
肉末茄香盖饭	盖浇饭	主食	饭	盖浇饭
肉末蔬菜粥	粥	主食	粥	
肉末豆腐套饭	其他饭	主食	饭	其他饭
肉末豆腐盖饭	盖浇饭	主食	饭	盖浇饭
肉末豆腐饭	盖浇饭	主食	饭	盖浇饭
肉末豇豆面	盖浇面	主食	面	盖浇面
肉末青菜粥	粥	主食	粥	
肉末香菇热汤面	汤面	主食	面	汤面
肉末鸡蛋打卤面	盖浇面	主食	面	盖浇面
肉末黄豆芽炒粉条	热菜	菜品	热菜	
肉松鸡蛋黑米饭	焖饭	主食	饭	焖饭
肉枣鲜菌汤	汤羹	菜品	汤羹	
肉汁炒萝卜	热菜	菜品	热菜	
肉沫娃娃菜	热菜	菜品	热菜	
肉沫小白菜	热菜	菜品	热菜	
肉沫小白菜饭	盖浇饭	主食	饭	盖浇饭
肉沫扒菠菜	热菜	菜品	热菜	
肉沫扒豆腐炒菜	热菜	菜品	热菜	
肉沫榛蘑小白菜	热菜	菜品	热菜	
肉沫洋白菜	热菜	菜品	热菜	
肉沫炒芥菜	热菜	菜品	热菜	
肉沫炒豆角	热菜	菜品	热菜	
肉沫炒酸豆角	热菜	菜品	热菜	
肉沫炖豆腐	热菜	菜品	热菜	
肉沫粉丝小白菜	热菜	菜品	热菜	
肉沫粉条圆包菜	热菜	菜品	热菜	
肉沫粉条小白菜	热菜	菜品	热菜	
肉沫茄子加一份米饭	其他菜品	其他	其他菜品	
肉沫茄子打卤面	盖浇面	主食	面	盖浇面
肉沫茄子盖浇饭	盖浇饭	主食	饭	盖浇饭
肉沫茄子菜	热菜	菜品	热菜	
肉沫茄子饭	盖浇饭	主食	饭	盖浇饭
肉沫茄条盒饭	其他饭	主食	饭	其他饭
肉沫茄条饭	盖浇饭	主食	饭	盖浇饭
肉沫蛋花汤	汤羹	菜品	汤羹	
肉沫豆腐盖浇饭	盖浇饭	主食	饭	盖浇饭
肉沫豆腐盖饭	盖浇饭	主食	饭	盖浇饭
肉沫豆腐饭	盖浇饭	主食	饭	盖浇饭
肉沫豆角打卤面	盖浇面	主食	面	盖浇面
肉沫酸白菜	热菜	菜品	热菜	
肉沫雪菜炒蚕豆	热菜	菜品	热菜	
肉沫青菜粥	粥	主食	粥	
肉沬湘西外婆菜	热菜	菜品	热菜	
肉泥蒸蛋汤	汤羹	菜品	汤羹	
肉渣小白菜	热菜	菜品	热菜	
肉炒土豆丝小份	热菜	菜品	热菜	
肉炒土豆片	热菜	菜品	热菜	
肉炒娃娃菜	热菜	菜品	热菜	
肉炒尖椒干豆腐	热菜	菜品	热菜	
肉炒山木耳	热菜	菜品	热菜	
肉炒山野菜	热菜	菜品	热菜	
肉炒干豆腐	热菜	菜品	热菜	
肉炒干豆腐白菜片	热菜	菜品	热菜	
肉炒干豆角丝	热菜	菜品	热菜	
肉炒扁豆丝	热菜	菜品	热菜	
肉炒有机菜花	热菜	菜品	热菜	
肉炒有机菜花半盘	热菜	菜品	热菜	
肉炒杏鲍菇丝	热菜	菜品	热菜	
肉炒杏鲍菇木耳	热菜	菜品	热菜	
肉炒滑子菇	热菜	菜品	热菜	
肉炒滑子蘑	热菜	菜品	热菜	
肉炒甘蓝粉	热菜	菜品	热菜	
肉炒笨豆芽	热菜	菜品	热菜	
肉炒笨豆芽小份	热菜	菜品	热菜	
肉炒笨豆芽干豆腐	热菜	菜品	热菜	
肉炒绿豆芽	热菜	菜品	热菜	
肉炒胡萝卜丝	热菜	菜品	热菜	
肉炒花菜十米饭	热菜	菜品	热菜	
肉炒芸豆丝	热菜	菜品	热菜	
肉炒芹菜盖饭	盖浇饭	主食	饭	盖浇饭
肉炒芹菜粉	热菜	菜品	热菜	
肉炒芹菜粉条	热菜	菜品	热菜	
肉炒菜花半盘	热菜	菜品	热菜	
肉炒菜花小份	热菜	菜品	热菜	
肉炒菠菜粉丝	热菜	菜品	热菜	
肉炒蒜苔半份	热菜	菜品	热菜	
肉炒西兰花	热菜	菜品	热菜	
肉炒西葫芦	热菜	菜品	热菜	
肉炒西葫芦盖饭	盖浇饭	主食	饭	盖浇饭
肉炒豆芽粉	热菜	菜品	热菜	
肉炒豆角丝	热菜	菜品	热菜	
肉炒豇豆角半盘	热菜	菜品	热菜	
肉炒青椒芹菜	热菜	菜品	热菜	
肉炒香菇油菜	热菜	菜品	热菜	
肉炒黄瓜片	热菜	菜品	热菜	
肉炒黄蘑土豆片	热菜	菜品	热菜	
肉炒黄豆芽	热菜	菜品	热菜	
肉烩圆白菜	热菜	菜品	热菜	
肉燥烩青菜	热菜	菜品	热菜	
肉片土豆丝饭	盖浇饭	主食	饭	盖浇饭
肉片木耳汤面	汤面	主食	面	汤面
肉片炒东北黑木耳	热菜	菜品	热菜	
肉片炒丝瓜	热菜	菜品	热菜	
肉片炒冬笋	热菜	菜品	热菜	
肉片炒木耳	热菜	菜品	热菜	
肉片炒甜椒	热菜	菜品	热菜	
肉片白菜炖豆腐粉条	热菜	菜品	热菜	
肉片白菜粉条炖豆腐	热菜	菜品	热菜	
肉片茄子小碗菜	热菜	菜品	热菜	
肉片豆角炒菜	热菜	菜品	热菜	
肉片青菜饭	盖浇饭	主食	饭	盖浇饭
肉皮炒芹菜	热菜	菜品	热菜	
肉碎茄子饭	盖浇饭	主食	饭	盖浇饭
肉粒香菇饭	盖浇饭	主食	饭	盖浇饭
肉羹豆腐汤	汤羹	菜品	汤羹	
肉臊子干拌菠菜面	拌面	主食	面	拌面
肉臊番茄二合一面	汤面	主食	面	汤面
肉饼蒸蛋饭	盖浇饭	主食	饭	盖浇饭
肉香烫白菜	热菜	菜品	热菜	
肋骨海带豆腐粉条米饭	其他菜品	其他	其他菜品	
肚丝炒茭白	热菜	菜品	热菜	
肚丝素交面	汤面	主食	面	汤面
肚片冬瓜汤	汤羹	菜品	汤羹	
肥牛菠菜荞麦凉拌面	健康餐	色拉轻食	健康餐	
胖鱼头炖豆腐	热菜	菜品	热菜	
胚芽白米饭	白米饭	主食	饭	白米饭
胚芽米白粥	粥	主食	粥	
胡同小拌菜	凉菜	菜品	凉菜	
胡椒莲子猪肚汤	汤羹	菜品	汤羹	
胡油韭菜炒鸡蛋半份菜	热菜	菜品	热菜	
胡瓜肉丝汤	汤羹	菜品	汤羹	
胡萝卜丝炒盐菜	热菜	菜品	热菜	
胡萝卜丝炒肉	热菜	菜品	热菜	
胡萝卜丝炒肉丝	热菜	菜品	热菜	
胡萝卜炒牛肉	热菜	菜品	热菜	
胡萝卜炒粉条	热菜	菜品	热菜	
胡萝卜炒肉	热菜	菜品	热菜	
胡萝卜炒肉丝	热菜	菜品	热菜	
胡萝卜炒肉沫	热菜	菜品	热菜	
胡萝卜炒肉片	热菜	菜品	热菜	
胡萝卜炒肉盖饭	盖浇饭	主食	饭	盖浇饭
胡萝卜炒蛋	热菜	菜品	热菜	
胡萝卜炒鸡丝	热菜	菜品	热菜	
胡萝卜片炒土猪肉	热菜	菜品	热菜	
胡萝卜牛肉粥	粥	主食	粥	
胡萝卜玉米煲龙骨汤	汤羹	菜品	汤羹	
胡萝卜玉米龙骨汤	汤羹	菜品	汤羹	
胡萝卜瘦肉粥	粥	主食	粥	
胡萝卜菠菜粥	粥	主食	粥	
胡萝卜青菜粥	粥	主食	粥	
胡麻奶白菜	热菜	菜品	热菜	
胶东大拌菜	凉菜	菜品	凉菜	
胶东打卤面	盖浇面	主食	面	盖浇面
胶州小米粥	粥	主食	粥	
脆果仁拌菠菜	凉菜	菜品	凉菜	
脆果仁绿菠菜	凉菜	菜品	凉菜	
脆炒小黄瓜	热菜	菜品	热菜	
脆爽圆白菜	热菜	菜品	热菜	
脆笋炒肉丝	热菜	菜品	热菜	
脆笋炒豆干	热菜	菜品	热菜	
脆肉皖鱼头粥	粥	主食	粥	
脆脆豆芽菜	热菜	菜品	热菜	
脆莴笋炒藕尖	热菜	菜品	热菜	
脱脂卤肉饭	盖浇饭	主食	饭	盖浇饭
脱骨黄花鱼小份菜	热菜	菜品	热菜	
腊八五味粥	粥	主食	粥	
腊八粥菜粥	粥	主食	粥	
腊八营养香甜八宝粥	粥	主食	粥	
腊八蒜炒杏鲍菇	热菜	菜品	热菜	
腊八蒜炒莜面鱼	炒面	主食	面	炒面
腊八蒜炒藕	热菜	菜品	热菜	
腊八蒜炒藕片	热菜	菜品	热菜	
腊八豆炒蛋	热菜	菜品	热菜	
腊八豆青椒炒蛋	热菜	菜品	热菜	
腌包菜炒虾皮	热菜	菜品	热菜	
腌菜炒鸡蛋	热菜	菜品	热菜	
腐乳椒丝空心菜	热菜	菜品	热菜	
腐皮小青菜	热菜	菜品	热菜	
腐皮毛毛菜	热菜	菜品	热菜	
腐皮油冬菜	热菜	菜品	热菜	
腐皮炒青菜	热菜	菜品	热菜	
腐皮青菜或大白菜	热菜	菜品	热菜	
腐皮鸡毛菜	热菜	菜品	热菜	
腐竹小拌菜	凉菜	菜品	凉菜	
腐竹拌合菜	凉菜	菜品	凉菜	
腐竹拌芹菜	凉菜	菜品	凉菜	
腐竹木耳炒肉	热菜	菜品	热菜	
腐竹木耳炒肉盖饭	盖浇饭	主食	饭	盖浇饭
腐竹炒大白菜	热菜	菜品	热菜	
腐竹炒小白菜	热菜	菜品	热菜	
腐竹炒木耳	热菜	菜品	热菜	
腐竹炒肉丝	热菜	菜品	热菜	
腐竹炒肉浇头	热菜	菜品	热菜	
腐竹炒肉片	热菜	菜品	热菜	
腐竹炒芹菜	热菜	菜品	热菜	
腐竹炒黑木耳	热菜	菜品	热菜	
腐竹炖荷包蛋	热菜	菜品	热菜	
腐竹菠菜菜	热菜	菜品	热菜	
腐竹龙须菜	凉菜	菜品	凉菜	
腔骨炖豆角土豆	热菜	菜品	热菜	
腩汁烫生菜	热菜	菜品	热菜	
腰果炒全素	热菜	菜品	热菜	
腰果炒玉米	热菜	菜品	热菜	
腰果炒虾仁	热菜	菜品	热菜	
膏蟹鲜虾粥	粥	主食	粥	
臊子打卤面	盖浇面	主食	面	盖浇面
自做水果汤	其他甜品	甜点	其他甜品	
自制丸子汤	汤羹	菜品	汤羹	
自制八宝粥	粥	主食	粥	
自制南瓜粥	粥	主食	粥	
自制圆白菜	浇头	菜品	浇头	
自制桂花红豆粥	粥	主食	粥	
自制炒雪里红	热菜	菜品	热菜	
自制笨豆芽炒粉	热菜	菜品	热菜	
自制红豆粥	粥	主食	粥	
自制萝卜丸子汤	汤羹	菜品	汤羹	
自制蔬菜面	其他菜品	其他	其他菜品	
自制酸包菜	浇头	其他	浇头	
自制酸爽包菜	浇头	其他	浇头	
自制酸菜炒肉丝	热菜	菜品	热菜	
自制鸡蛋麦面	其他面	主食	面	其他面
自制黄花鱼丸汤	汤羹	菜品	汤羹	
自家味道疙瘩汤	汤羹	菜品	汤羹	
自家炒合菜	热菜	菜品	热菜	
自家熬的小米粥	粥	主食	粥	
自拌黄瓜咸菜	凉菜	菜品	凉菜	
自然农法小米粥	粥	主食	粥	
自煮红豆汤	糖水/炖品	甜点	糖水/炖品	
自煮血糯米粥	粥	主食	粥	
自熬八宝粥	粥	主食	粥	
自熬小米粥	粥	主食	粥	
自熬绿豆粥	粥	主食	粥	
自穿碳烤圆白菜	蔬菜类	烧烤	蔬菜类	
自选加料蔬菜	浇头	其他	浇头	
自选单点米饭	白米饭	主食	饭	白米饭
自选大头菜	蔬菜类	火锅/串串/麻辣烫/色拉自选	配菜	蔬菜类
自选称重白菜	蔬菜类	火锅/串串/麻辣烫/色拉自选	配菜	蔬菜类
臻菌小壶汤	汤羹	菜品	汤羹	
舌尖大拌菜	凉菜	菜品	凉菜	
舍外八宝粥	粥	主食	粥	
舒兰香米饭	白米饭	主食	饭	白米饭
艳河长粒香米饭	白米饭	主食	饭	白米饭
艽菜炒笨鸡蛋	热菜	菜品	热菜	
芋圆紫米粥	粥	主食	粥	
芋圆绿豆汤	糖水/炖品	甜点	糖水/炖品	
芋头大锅菜	热菜	菜品	热菜	
芋头炒毛豆	热菜	菜品	热菜	
芋头炒米面	炒面	主食	面	炒面
芋头炖芸豆	热菜	菜品	热菜	
芋头炖芸豆粉条	热菜	菜品	热菜	
芋头猪肉丸子汤	汤羹	菜品	汤羹	
芋头砂锅粥	粥	主食	粥	
芋头青菜汤	汤羹	菜品	汤羹	
芋头骨头汤	汤羹	菜品	汤羹	
芋泥乌米饭	其他饭	主食	饭	其他饭
芋艿滚青菜	热菜	菜品	热菜	
芋艿肉丝汤	汤羹	菜品	汤羹	
芒果银耳炖雪梨	其他甜品	甜点	其他甜品	
芙蓉果蔬汤	汤羹	菜品	汤羹	
芙蓉紫菜蛋花汤	汤羹	菜品	汤羹	
芙蓉蔬菜汤	汤羹	菜品	汤羹	
芙蓉鲜蔬汤	汤羹	菜品	汤羹	
芝麻叶豆腐汤	汤羹	菜品	汤羹	
芝麻拌菠菜	凉菜	菜品	凉菜	
芝麻核桃粥	粥	主食	粥	
芝麻核桃蛋汤	糖水/炖品	甜点	糖水/炖品	
芝麻裙带菜	凉菜	菜品	凉菜	
芡实莲子粥	粥	主食	粥	
芥兰炒牛柳	热菜	菜品	热菜	
芥兰炒虾球	热菜	菜品	热菜	
芥味裙带菜	凉菜	菜品	凉菜	
芥菜丝是炒黄豆	热菜	菜品	热菜	
芥菜丝炒肉	热菜	菜品	热菜	
芥菜干贝粥	粥	主食	粥	
芥菜樱炖豆腐	热菜	菜品	热菜	
芥菜炒肉丝	热菜	菜品	热菜	
芥菜炒虾皮	热菜	菜品	热菜	
芥菜炒蚕豆	热菜	菜品	热菜	
芥菜炒黄豆芽	凉菜	菜品	凉菜	
芥菜炖豆腐	热菜	菜品	热菜	
芥菜烧骨粥	粥	主食	粥	
芥菜瘦肉粥	粥	主食	粥	
芥菜缨炖豆腐	热菜	菜品	热菜	
芥菜肉末手擀面	手擀面	主食	面	手擀面
芥蓝炒牛肉	热菜	菜品	热菜	
芦笋木耳炒鸡球	热菜	菜品	热菜	
芦笋炒口蘑	热菜	菜品	热菜	
芦笋炒山药	热菜	菜品	热菜	
芦笋炒牛肉	热菜	菜品	热菜	
芦笋炒虾仁	热菜	菜品	热菜	
芦笋苗炒虾仁	热菜	菜品	热菜	
芦芽肉丝炒香干	热菜	菜品	热菜	
芦蒿炒白香干	热菜	菜品	热菜	
芦蒿炒香干	热菜	菜品	热菜	
芮城砂锅花菜	热菜	菜品	热菜	
花旗参乌鸡汤	汤羹	菜品	汤羹	
花旗参乌鸡瓦罐汤	汤羹	菜品	汤羹	
花旗参乌鸡面	汤面	主食	面	汤面
花旗参乳鸽汤	汤羹	菜品	汤羹	
花旗参炖乌鸡	汤羹	菜品	汤羹	
花旗参炖乌鸡汤	汤羹	菜品	汤羹	
花旗参炖瘦肉	汤羹	菜品	汤羹	
花旗参炖竹丝鸡	汤羹	菜品	汤羹	
花旗参炖竹丝鸡汤	汤羹	菜品	汤羹	
花旗参石斛炖瘦肉	汤羹	菜品	汤羹	
花旗参竹丝鸡汤	汤羹	菜品	汤羹	
花旗参红枣桂圆枸杞炖鸽子汤	汤羹	菜品	汤羹	
花旗参鸽子汤	汤羹	菜品	汤羹	
花生地瓜粥	粥	主食	粥	
花生巴戟杜仲猪尾汤	汤羹	菜品	汤羹	
花生拌菠菜	凉菜	菜品	凉菜	
花生杂粮粥	粥	主食	粥	
花生桂圆红枣汤	糖水/炖品	甜点	糖水/炖品	
花生浆稀饭	粥	主食	粥	
花生米拌芹菜	凉菜	菜品	凉菜	
花生米炒萝卜丝	热菜	菜品	热菜	
花生米炝芹菜	凉菜	菜品	凉菜	
花生米芹菜	浇头	其他	浇头	
花生米芹菜叶咸汤	汤羹	菜品	汤羹	
花生米菜粥	粥	主食	粥	
花生红枣汤	糖水/炖品	甜点	糖水/炖品	
花生红枣粥	粥	主食	粥	
花生红豆粥	粥	主食	粥	
花生萝卜丝汤	汤羹	菜品	汤羹	
花生萝卜咸汤	汤羹	菜品	汤羹	
花生萝卜汤	汤羹	菜品	汤羹	
花生蛋花汤	汤羹	菜品	汤羹	
花生银耳汤	糖水/炖品	甜点	糖水/炖品	
花生青菜粥	粥	主食	粥	
花生黑米粥	粥	主食	粥	
花甲丝瓜汤	汤羹	菜品	汤羹	
花甲干贝鲜虾粥	粥	主食	粥	
花菜家常炒	热菜	菜品	热菜	
花菜炒木耳	热菜	菜品	热菜	
花菜炒瘦肉	热菜	菜品	热菜	
花菜炒肉丁	热菜	菜品	热菜	
花菜炒肉丝	热菜	菜品	热菜	
花菜炒肉片	热菜	菜品	热菜	
花菜炒脱骨肉	热菜	菜品	热菜	
花菜炒西红柿	热菜	菜品	热菜	
花菜炒豆腐	热菜	菜品	热菜	
花菜炒豆腐泡	热菜	菜品	热菜	
花菜炒贝丁	热菜	菜品	热菜	
花菜炒鸡蛋	热菜	菜品	热菜	
花菜鱼圆汤	汤羹	菜品	汤羹	
花菜鹌鹑蛋汤	汤羹	菜品	汤羹	
花蛤冬瓜汤	汤羹	菜品	汤羹	
花蛤枸杞叶汤	汤羹	菜品	汤羹	
花蛤海虾粥	粥	主食	粥	
花蛤瘦肉汤	汤羹	菜品	汤羹	
花蛤苦瓜汤	汤羹	菜品	汤羹	
花蛤茶树菇汤	汤羹	菜品	汤羹	
花蛤豆腐汤	热菜	菜品	热菜	
花蟹干贝粥	粥	主食	粥	
花链鱼头豆腐汤	汤羹	菜品	汤羹	
花鲢鱼头汤	汤羹	菜品	汤羹	
花鲢鱼头豆腐汤	汤羹	菜品	汤羹	
芸豆丝炒土豆丝	热菜	菜品	热菜	
芸豆丝炒肉	热菜	菜品	热菜	
芸豆丝炒肉丝	热菜	菜品	热菜	
芸豆丝炒肉小份	热菜	菜品	热菜	
芸豆土豆粘玉米焖手杆面	焖面	主食	面	焖面
芸豆大楂子粥	粥	主食	粥	
芸豆打卤面	盖浇面	主食	面	盖浇面
芸豆炒肉丝	热菜	菜品	热菜	
芸豆炖土豆	热菜	菜品	热菜	
芸豆烧茄子盖面	盖浇面	主食	面	盖浇面
芸豆肚片汤	汤羹	菜品	汤羹	
芸豆花蛤打卤面	盖浇面	主食	面	盖浇面
芹叶疙瘩汤	汤羹	菜品	汤羹	
芹椒花菜炒肉	热菜	菜品	热菜	
芹米炒肉片	热菜	菜品	热菜	
芹菜叶炒蛋	热菜	菜品	热菜	
芹菜土豆丝盖饭	盖浇饭	主食	饭	盖浇饭
芹菜小炒牛肉	热菜	菜品	热菜	
芹菜尖椒炒肉	热菜	菜品	热菜	
芹菜干丝炒肉丝十米饭	其他菜品	其他	其他菜品	
芹菜干丝盖浇饭	盖浇饭	主食	饭	盖浇饭
芹菜干子炒肉	其他菜品	其他	其他菜品	
芹菜木耳炒尖椒	热菜	菜品	热菜	
芹菜木耳炒肉	热菜	菜品	热菜	
芹菜木耳炒肉丝	热菜	菜品	热菜	
芹菜炒三丝	热菜	菜品	热菜	
芹菜炒乌贼	热菜	菜品	热菜	
芹菜炒千张	热菜	菜品	热菜	
芹菜炒土豆丝	热菜	菜品	热菜	
芹菜炒土豆丝盖饭	盖浇饭	主食	饭	盖浇饭
芹菜炒土豆条加肉	热菜	菜品	热菜	
芹菜炒墨鱼干	热菜	菜品	热菜	
芹菜炒尖椒丝	热菜	菜品	热菜	
芹菜炒山药	热菜	菜品	热菜	
芹菜炒干丝	热菜	菜品	热菜	
芹菜炒干子	热菜	菜品	热菜	
芹菜炒木耳	热菜	菜品	热菜	
芹菜炒牛肉	热菜	菜品	热菜	
芹菜炒牛肉丝	热菜	菜品	热菜	
芹菜炒牛肚	热菜	菜品	热菜	
芹菜炒猪血	热菜	菜品	热菜	
芹菜炒粉丝	热菜	菜品	热菜	
芹菜炒粉条	热菜	菜品	热菜	
芹菜炒耳尖	热菜	菜品	热菜	
芹菜炒肉丝	热菜	菜品	热菜	
芹菜炒肉丝加米饭	其他菜品	其他	其他菜品	
芹菜炒肉丝干丝	热菜	菜品	热菜	
芹菜炒肉丝粉	热菜	菜品	热菜	
芹菜炒肉中份	热菜	菜品	热菜	
芹菜炒肉木桶饭	木桶饭	主食	饭	木桶饭
芹菜炒肉炒码	热菜	菜品	热菜	
芹菜炒肉盖饭	盖浇饭	主食	饭	盖浇饭
芹菜炒肉粉条	热菜	菜品	热菜	
芹菜炒肉饭	盖浇饭	主食	饭	盖浇饭
芹菜炒腐竹	热菜	菜品	热菜	
芹菜炒藕丝	热菜	菜品	热菜	
芹菜炒豆干	热菜	菜品	热菜	
芹菜炒豆皮	热菜	菜品	热菜	
芹菜炒豆腐	热菜	菜品	热菜	
芹菜炒豆腐干	热菜	菜品	热菜	
芹菜炒豆腐泡	热菜	菜品	热菜	
芹菜炒青椒	热菜	菜品	热菜	
芹菜炒青椒一份	热菜	菜品	热菜	
芹菜炒香干	热菜	菜品	热菜	
芹菜炒香干子	热菜	菜品	热菜	
芹菜炒香干木桶饭	木桶饭	主食	饭	木桶饭
芹菜炒香干盖饭	盖浇饭	主食	饭	盖浇饭
芹菜炒鱼饼	热菜	菜品	热菜	
芹菜炒鸡丝	热菜	菜品	热菜	
芹菜炒鸡肉小份	热菜	菜品	热菜	
芹菜炒黄豆芽	热菜	菜品	热菜	
芹菜牛肉饭	盖浇饭	主食	饭	盖浇饭
芹菜白玉菇炒肉丝	热菜	菜品	热菜	
芹菜粉条炒肉	热菜	菜品	热菜	
芹菜粉炒肉	热菜	菜品	热菜	
芹菜细粉炒肉	热菜	菜品	热菜	
芹菜肉丝小炒	热菜	菜品	热菜	
芹菜肉丝拌面	拌面	主食	面	拌面
芹菜肉丝炒木耳	热菜	菜品	热菜	
芹菜肉丝炒粉条	热菜	菜品	热菜	
芹菜肉丝炒香干	热菜	菜品	热菜	
芹菜肉丝盖浇饭	盖浇饭	主食	饭	盖浇饭
芹菜肉丝盖饭	盖浇饭	主食	饭	盖浇饭
芹菜肉丝饭	盖浇饭	主食	饭	盖浇饭
芹菜腐竹炒木耳	热菜	菜品	热菜	
芹菜蒜炒香干	热菜	菜品	热菜	
芹菜豆干炒肉	热菜	菜品	热菜	
芹菜豆干炒肉丝	热菜	菜品	热菜	
芹菜酸罗卜炒肉丝	热菜	菜品	热菜	
芹菜青椒炒肉	热菜	菜品	热菜	
芹菜香干炒肉丝	热菜	菜品	热菜	
芹菜香干炒肉丝盖浇饭	盖浇饭	主食	饭	盖浇饭
芹菜香干炒肉煲	煲仔饭	主食	饭	煲仔饭
芹菜香干煲十紫砂煲米饭	其他菜品	其他	其他菜品	
芹菜香干盖浇饭	盖浇饭	主食	饭	盖浇饭
芹菜香干肉丝木桶盖饭	木桶饭	主食	饭	木桶饭
芹菜香干肉丝木桶饭	木桶饭	主食	饭	木桶饭
芹菜香干肉丝瓦煲饭	煲仔饭	主食	饭	煲仔饭
芹菜香干肉丝盖浇饭	盖浇饭	主食	饭	盖浇饭
芹菜香干肉丝盖饭	盖浇饭	主食	饭	盖浇饭
芹菜香干肉丝饭	盖浇饭	主食	饭	盖浇饭
芹菜香干饭	盖浇饭	主食	饭	盖浇饭
芹菜香炒牛肉	热菜	菜品	热菜	
芹菜香菇粥	粥	主食	粥	
芹菜鹅肠炒黄豆芽	热菜	菜品	热菜	
芹香土豆丝汤	汤羹	菜品	汤羹	
苏北香米饭	白米饭	主食	饭	白米饭
苏州味道阿婆菜	凉菜	菜品	凉菜	
苏式传统阳春面	汤面	主食	面	汤面
苗家外婆菜炒蛋	热菜	菜品	热菜	
苜蓿小白菜	热菜	菜品	热菜	
苤蓝丝炒黄豆	热菜	菜品	热菜	
苦瓜山药炒木耳	热菜	菜品	热菜	
苦瓜山药炒珍菌	热菜	菜品	热菜	
苦瓜干贝粥	粥	主食	粥	
苦瓜排骨汤	汤羹	菜品	汤羹	
苦瓜排骨煨汤	汤羹	菜品	汤羹	
苦瓜木耳炒鸡蛋	热菜	菜品	热菜	
苦瓜海带炖龙骨	汤羹	菜品	汤羹	
苦瓜炒土鸡蛋	热菜	菜品	热菜	
苦瓜炒木耳	热菜	菜品	热菜	
苦瓜炒梅干菜	热菜	菜品	热菜	
苦瓜炒肉丝	热菜	菜品	热菜	
苦瓜炒肉片	热菜	菜品	热菜	
苦瓜炒肉饭	盖浇饭	主食	饭	盖浇饭
苦瓜炒虾仁	热菜	菜品	热菜	
苦瓜炒蛋饭	盖浇饭	主食	饭	盖浇饭
苦瓜炒豆丝	热菜	菜品	热菜	
苦瓜炒酸菜外婆菜随机	热菜	菜品	热菜	
苦瓜炒鸡蛋	热菜	菜品	热菜	
苦瓜炒鸡蛋盖饭	盖浇饭	主食	饭	盖浇饭
苦瓜瘦肉汤	汤羹	菜品	汤羹	
苦瓜瘦肉粥	粥	主食	粥	
苦瓜皮蛋汤	汤羹	菜品	汤羹	
苦瓜肉丝粥	粥	主食	粥	
苦瓜肉丝饭	盖浇饭	主食	饭	盖浇饭
苦瓜肉泥汤	汤羹	菜品	汤羹	
苦瓜肉片饭	盖浇饭	主食	饭	盖浇饭
苦瓜花蛤汤	汤羹	菜品	汤羹	
苦瓜蛋花粥	粥	主食	粥	
苦瓜蛤蜊汤	汤羹	菜品	汤羹	
苦瓜鸡蛋盖饭	盖浇饭	主食	饭	盖浇饭
苦瓜鸡蛋饭	盖浇饭	主食	饭	盖浇饭
苦瓜黄豆排骨汤	汤羹	菜品	汤羹	
苦瓜黄豆炖尾骨	汤羹	菜品	汤羹	
苦荞小米南瓜粥	粥	主食	粥	
苦荞小米粥	粥	主食	粥	
苦荞清心小米粥	粥	主食	粥	
苦菜鸡蛋炒饭	炒饭	主食	饭	炒饭
苹果紫菜饭	寿司	主食	寿司	
茄丁打卤面	盖浇面	主食	面	盖浇面
茄丁香菇面	盖浇面	主食	面	盖浇面
茄丝炝锅面	汤面	主食	面	汤面
茄丝肉丝打卤面	盖浇面	主食	面	盖浇面
茄子丝炒土豆	热菜	菜品	热菜	
茄子丝炒鸡蛋	热菜	菜品	热菜	
茄子土豆泥套餐含米饭	其他菜品	其他	其他菜品	
茄子土豆肉丁打卤面	盖浇面	主食	面	盖浇面
茄子扁豆饭	盖浇饭	主食	饭	盖浇饭
茄子手擀面	手擀面	主食	面	手擀面
茄子打卤刀削面	其他面	主食	面	其他面
茄子打卤面	盖浇面	主食	面	盖浇面
茄子拼豆角饭	盖浇饭	主食	饭	盖浇饭
茄子炒缸豆	热菜	菜品	热菜	
茄子炒肉丝	热菜	菜品	热菜	
茄子炒豆角	热菜	菜品	热菜	
茄子炒豇豆	热菜	菜品	热菜	
茄子炒长豆角	热菜	菜品	热菜	
茄子炖土豆	热菜	菜品	热菜	
茄子炖土豆泥图片仅供参考	热菜	菜品	热菜	
茄子炖扇贝	热菜	菜品	热菜	
茄子炖蚬子	热菜	菜品	热菜	
茄子烧长豆角木桶饭	木桶饭	主食	饭	木桶饭
茄子爱上土豆饭	盖浇饭	主食	饭	盖浇饭
茄子盖浇饭	盖浇饭	主食	饭	盖浇饭
茄子素卤面	焖面	主食	面	焖面
茄子素打卤面	盖浇面	主食	面	盖浇面
茄子肉丁打卤面	盖浇面	主食	面	盖浇面
茄子肉丁面	盖浇面	主食	面	盖浇面
茄子肉丝打卤面	盖浇面	主食	面	盖浇面
茄子肉丝汤面	汤面	主食	面	汤面
茄子肉丝盖浇饭	盖浇饭	主食	饭	盖浇饭
茄子肉丝饭	盖浇饭	主食	饭	盖浇饭
茄子肉打卤面	盖浇面	主食	面	盖浇面
茄子肉末打卤面	盖浇面	主食	面	盖浇面
茄子肉末盖浇饭	盖浇饭	主食	饭	盖浇饭
茄子肉沫十米饭	其他菜品	其他	其他菜品	
茄子肉片饭	盖浇饭	主食	饭	盖浇饭
茄子肉米饭	盖浇饭	主食	饭	盖浇饭
茄子西红柿尖椒拌面	拌面	主食	面	拌面
茄子豆腐面	盖浇面	主食	面	盖浇面
茄子豆角双拼饭	盖浇饭	主食	饭	盖浇饭
茄子豆角木桶饭	木桶饭	主食	饭	木桶饭
茄子豆角炒肉饭	木桶饭	主食	饭	木桶饭
茄子豆角焖面	焖面	主食	面	焖面
茄子豆角盖浇饭	盖浇饭	主食	饭	盖浇饭
茄子豆角细面	盖浇面	主食	面	盖浇面
茄子豆角锅巴饭	盖浇饭	主食	饭	盖浇饭
茄子豆角饭	木桶饭	主食	饭	木桶饭
茄子长豆角木桶饭	木桶饭	主食	饭	木桶饭
茄子鸡丁盖饭	盖浇饭	主食	饭	盖浇饭
茄子鸡蛋拌面	拌面	主食	面	拌面
茄汁净素面	意大利面	主食	面	意大利面
茄汁蛋香面	汤面	主食	面	汤面
茉莉花炒土鸡蛋	热菜	菜品	热菜	
茉莉花炒蛋	热菜	菜品	热菜	
茉莉花炒鸡蛋	热菜	菜品	热菜	
茉莉香米饭	白米饭	主食	饭	白米饭
茉莉香贡菜	凉菜	菜品	凉菜	
茭瓜炒木耳	热菜	菜品	热菜	
茭瓜炒肉丝	热菜	菜品	热菜	
茭瓜炒鸡蛋	热菜	菜品	热菜	
茭白丝炒毛豆	热菜	菜品	热菜	
茭白丝炒肉丝	热菜	菜品	热菜	
茭白毛豆炒肉丝	热菜	菜品	热菜	
茭白炒毛豆	热菜	菜品	热菜	
茭白炒肉丝	热菜	菜品	热菜	
茭白炒肉片	热菜	菜品	热菜	
茭白炒肉肉	热菜	菜品	热菜	
茭白炒虾仁	热菜	菜品	热菜	
茭白炒鸡蛋	热菜	菜品	热菜	
茭白肉丝盖浇饭	盖浇饭	主食	饭	盖浇饭
茭白青椒炒肉丝	热菜	菜品	热菜	
茭菜炒肉丝	热菜	菜品	热菜	
茯苓养胃粥	粥	主食	粥	
茴子白炒粉条	热菜	菜品	热菜	
茴香豆米汤	汤羹	菜品	汤羹	
茶树茹老鸭汤	汤羹	菜品	汤羹	
茶树菇乌鸡汤	汤羹	菜品	汤羹	
茶树菇党参枸杞老鸭汤	汤羹	菜品	汤羹	
茶树菇土鸡汤	汤羹	菜品	汤羹	
茶树菇小白菜	热菜	菜品	热菜	
茶树菇拌面	拌面	主食	面	拌面
茶树菇排股汤	汤羹	菜品	汤羹	
茶树菇枸杞老鸭面	汤面	主食	面	汤面
茶树菇炒肉丝	热菜	菜品	热菜	
茶树菇炒肉盖浇米饭	盖浇饭	主食	饭	盖浇饭
茶树菇炒茼蒿	热菜	菜品	热菜	
茶树菇炖土鸡汤	汤羹	菜品	汤羹	
茶树菇炖小鸡	汤羹	菜品	汤羹	
茶树菇炖罐	汤羹	菜品	汤羹	
茶树菇炖老鸭汤	汤羹	菜品	汤羹	
茶树菇炖豆腐堡	热菜	菜品	热菜	
茶树菇老鸭汤	汤羹	菜品	汤羹	
茶树菇老鸭汤饭	泡饭	主食	饭	泡饭
茶树菇老鸭瓦罐汤	汤羹	菜品	汤羹	
茶树菇老鸭面	汤面	主食	面	汤面
茶树菇鸡汤	汤羹	菜品	汤羹	
茶笋黄瓜盖浇饭	盖浇饭	主食	饭	盖浇饭
茶菇水鸭汤	汤羹	菜品	汤羹	
茼蒿拼油麦菜	蔬菜类	火锅/串串/麻辣烫/色拉自选	配菜	蔬菜类
茼蒿炒香干	热菜	菜品	热菜	
草原大拌菜	凉菜	菜品	凉菜	
草本鸡汤面	汤面	主食	面	汤面
草根老鸭汤	汤羹	菜品	汤羹	
草莓雪梨粥	粥	主食	粥	
草菇芥兰炒虾仁	热菜	菜品	热菜	
草鸡冬瓜血汤	汤羹	菜品	汤羹	
草鸡炖香菇	热菜	菜品	热菜	
草鸡鸡蛋汤	汤羹	菜品	汤羹	
荔枝湾艇仔粥	粥	主食	粥	
荔湾艇仔粥	粥	主食	粥	
荞面酸汤饸饹面	汤面	主食	面	汤面
荞麦大冷面	凉面	主食	面	凉面
荞麦小米粥	粥	主食	粥	
荞麦拌冷面	凉面	主食	面	凉面
荞麦栗子粥	粥	主食	粥	
荞麦葱花面	汤面	主食	面	汤面
荞麦酸甜冷面	凉面	主食	面	凉面
荞麦酸菜牛肉面	其他面	主食	面	其他面
荞麦韩式冷面	凉面	主食	面	凉面
荠菜云吞面	其他面	主食	面	其他面
荠菜圆子菠菜汤	汤羹	菜品	汤羹	
荠菜炒鸡蛋	热菜	菜品	热菜	
荠菜磨糊汤	汤羹	菜品	汤羹	
荠菜肉丝豆腐汤	汤羹	菜品	汤羹	
荠菜肉末豆腐汤	汤羹	菜品	汤羹	
荠菜蘑菇炒山药	热菜	菜品	热菜	
荠菜蘑菇炒鱼片	热菜	菜品	热菜	
荠菜蛋炒饭	炒饭	主食	饭	炒饭
荠菜豆腐汤	汤羹	菜品	汤羹	
荠菜馄饨汤	馄饨	主食	馄饨	
荠菜鸡蛋粥	粥	主食	粥	
荣食方虾仁蛋炒饭	炒饭	主食	饭	炒饭
荤加素拼盒饭	其他饭	主食	饭	其他饭
药膳乌鸡汤	汤羹	菜品	汤羹	
药膳土鸭汤	汤羹	菜品	汤羹	
药膳滋补烩面	其他面	主食	面	其他面
药膳花胶炖土鸡汤	汤羹	菜品	汤羹	
药膳鸽子汤	汤羹	菜品	汤羹	
药芹炒干子	热菜	菜品	热菜	
药芹炒肉丝	热菜	菜品	热菜	
药芹炒香干	热菜	菜品	热菜	
荷兰豆小炒半份	热菜	菜品	热菜	
荷兰豆炒双鲜	热菜	菜品	热菜	
荷兰豆炒木耳	热菜	菜品	热菜	
荷兰豆炒肉	热菜	菜品	热菜	
荷兰豆炒肉丝	热菜	菜品	热菜	
荷兰豆炒肉片	热菜	菜品	热菜	
荷兰豆炒虾仁	热菜	菜品	热菜	
荷包蛋炖鲜鱼	热菜	菜品	热菜	
荷包蛋素鸡面	汤面	主食	面	汤面
荷包蛋青菜面	汤面	主食	面	汤面
荷包鸡蛋卷十青菜瘦肉粥	卷饼	主食	饼/囊/馍	卷饼
荷包鹌鹑蛋烧花菜	热菜	菜品	热菜	
荷叶南瓜小米粥	粥	主食	粥	
荷叶大米粥	粥	主食	粥	
荷叶小米粥	粥	主食	粥	
荷叶尖炒鸡蛋	热菜	菜品	热菜	
荷叶尖炒鸡蛋份	热菜	菜品	热菜	
荷叶玉米粥	粥	主食	粥	
荷叶绿豆冰粥	粥	主食	粥	
荷叶莲子粥	粥	主食	粥	
荷叶饼加茶叶蛋加菜	夹饼/夹馍	主食	饼/囊/馍	夹饼/夹馍
荷叶饼加菜	夹饼/夹馍	主食	饼/囊/馍	夹饼/夹馍
荷叶饼夹菜	夹饼/夹馍	主食	饼/囊/馍	夹饼/夹馍
荷塘小炒小份	热菜	菜品	热菜	
荷塘炒虾仁外	热菜	菜品	热菜	
荷塘虾仁小炒	热菜	菜品	热菜	
荷香小炒虾球	热菜	菜品	热菜	
荼树菇炒肉	热菜	菜品	热菜	
莜面疙瘩汤	汤羹	菜品	汤羹	
莜面窝窝凉汤	凉面	主食	面	凉面
莜面窝窝配蔬菜汤	其他菜品	其他	其他菜品	
莲子八宝粥	粥	主食	粥	
莲子枸杞猪肚汤	汤羹	菜品	汤羹	
莲子桂圆汤	糖水/炖品	甜点	糖水/炖品	
莲子猪肚汤	汤羹	菜品	汤羹	
莲子猪肚汤面	汤面	主食	面	汤面
莲子猪肚汤饭	泡饭	主食	饭	泡饭
莲子百合粥	粥	主食	粥	
莲子百合银耳汤	糖水/炖品	甜点	糖水/炖品	
莲子百合银耳红枣汤	糖水/炖品	甜点	糖水/炖品	
莲子紫米粥	粥	主食	粥	
莲子红枣糖粥	粥	主食	粥	
莲子红豆红糖粥	粥	主食	粥	
莲子绿豆汤	糖水/炖品	甜点	糖水/炖品	
莲子银耳汤	糖水/炖品	甜点	糖水/炖品	
莲子鲜奶炖蛋	糖水/炖品	甜点	糖水/炖品	
莲白炒粉丝	热菜	菜品	热菜	
莲花菜炒肉盖浇米饭	盖浇饭	主食	饭	盖浇饭
莲菜炒肉丝	热菜	菜品	热菜	
莲藕排骨汤	汤羹	菜品	汤羹	
莲藕排骨煨汤	汤羹	菜品	汤羹	
莲藕西洋菜汤	汤羹	菜品	汤羹	
莴笋丝炒肉	热菜	菜品	热菜	
莴笋丝炒肉丝	热菜	菜品	热菜	
莴笋丝炒蛋	热菜	菜品	热菜	
莴笋丝炒韭菜	热菜	菜品	热菜	
莴笋小炒木耳	热菜	菜品	热菜	
莴笋干炒肉	热菜	菜品	热菜	
莴笋干炒肉丝	热菜	菜品	热菜	
莴笋干青炒	热菜	菜品	热菜	
莴笋条炒肉	热菜	菜品	热菜	
莴笋炒山药	热菜	菜品	热菜	
莴笋炒木耳	热菜	菜品	热菜	
莴笋炒木耳肉丝	热菜	菜品	热菜	
莴笋炒精片	热菜	菜品	热菜	
莴笋炒肉丝	热菜	菜品	热菜	
莴笋炒肉十米饭	其他菜品	其他	其他菜品	
莴笋炒肉片	热菜	菜品	热菜	
莴笋炒菌菇	热菜	菜品	热菜	
莴笋炒金针菇	热菜	菜品	热菜	
莴笋炒韭菜	热菜	菜品	热菜	
莴笋炒鸡蛋	热菜	菜品	热菜	
莴笋片炒肉丝	热菜	菜品	热菜	
莴笋片炒肉小碗菜	热菜	菜品	热菜	
莴笋肉丝饭	盖浇饭	主食	饭	盖浇饭
莴苣丝炒肉丝	热菜	菜品	热菜	
莴苣炒木耳	热菜	菜品	热菜	
莴苣炒肉丝	热菜	菜品	热菜	
莴苣炒肉片	热菜	菜品	热菜	
莴苣炒虾仁	热菜	菜品	热菜	
莴苣炒鸡蛋	热菜	菜品	热菜	
莴苣片炒肉	热菜	菜品	热菜	
莴苣片炒肉片	热菜	菜品	热菜	
莴苣笋炒蛋	热菜	菜品	热菜	
菊花虾米粥	粥	主食	粥	
菌汤炖鸡面	汤面	主食	面	汤面
菌王鸡汤面	汤面	主食	面	汤面
菌菇乌鸡汤	汤羹	菜品	汤羹	
菌菇套餐饭	其他菜品	其他	其他菜品	
菌菇杂酱面	其他面	主食	面	其他面
菌菇汤泡饭	泡饭	主食	饭	泡饭
菌菇浓汤肉碎泡饭	泡饭	主食	饭	泡饭
菌菇炒油菜煲仔	热菜	菜品	热菜	
菌菇炒肉丝	热菜	菜品	热菜	
菌菇炒面筋	热菜	菜品	热菜	
菌菇炖豆腐	热菜	菜品	热菜	
菌菇牛肉粥	粥	主食	粥	
菌菇砂锅粥	粥	主食	粥	
菌菇素什锦刀削面	其他面	主食	面	其他面
菌菇素汤面	汤面	主食	面	汤面
菌菇肉丝汤	汤羹	菜品	汤羹	
菌菇肉丝盖浇饭	盖浇饭	主食	饭	盖浇饭
菌菇肉丝蛋花汤	汤羹	菜品	汤羹	
菌菇肉丝面	汤面	主食	面	汤面
菌菇肉丝饭	盖浇饭	主食	饭	盖浇饭
菌菇肉丸汤	汤羹	菜品	汤羹	
菌菇肉片汤	汤羹	菜品	汤羹	
菌菇胡辣汤	汤羹	菜品	汤羹	
菌菇虾仁拌面	拌面	主食	面	拌面
菌菇虾仁炒土鸡蛋	热菜	菜品	热菜	
菌菇豆腐肉丝汤	汤羹	菜品	汤羹	
菌菇豆腐菠菜汤	汤羹	菜品	汤羹	
菌菇鱼丸汤	汤羹	菜品	汤羹	
菌菇鱼元汤	汤羹	菜品	汤羹	
菌菇鲜贝粥	粥	主食	粥	
菌菇鸡丝汤	汤羹	菜品	汤羹	
菌菇鸡肉粥	粥	主食	粥	
菌菇黄鱼面	汤面	主食	面	汤面
菌香油麦菜	热菜	菜品	热菜	
菜干三鲜面	盖浇面	主食	面	盖浇面
菜心炒牛肉	热菜	菜品	热菜	
菜心牛肉粥	粥	主食	粥	
菜心玉米粥	粥	主食	粥	
菜心粒干贝粥	粥	主食	粥	
菜心虾滑粥	粥	主食	粥	
菜心豆腐汤	汤羹	菜品	汤羹	
菜根山菌汤	汤羹	菜品	汤羹	
菜梗炒肉丝	热菜	菜品	热菜	
菜瓜炒虾米	热菜	菜品	热菜	
菜秧豆腐汤	汤羹	菜品	汤羹	
菜籽油去皮番茄炒蛋	热菜	菜品	热菜	
菜籽油番茄炒蛋	热菜	菜品	热菜	
菜花木耳芹菜	热菜	菜品	热菜	
菜花炒瘦肉	热菜	菜品	热菜	
菜花炒肉一份	热菜	菜品	热菜	
菜花炒肉丝	热菜	菜品	热菜	
菜花炒肉丨种草	热菜	菜品	热菜	
菜花炒肉半份	热菜	菜品	热菜	
菜花炒肉片	热菜	菜品	热菜	
菜花西红柿盖饭	盖浇饭	主食	饭	盖浇饭
菜饭时蔬汤	其他菜品	其他	其他菜品	
菜饺子大头菜	饺子	主食	饺子	
菠菜丸子汤	汤羹	菜品	汤羹	
菠菜或小白菜	浇头	其他	浇头	
菠菜木耳炒蛋	热菜	菜品	热菜	
菠菜木耳炒鸡蛋	热菜	菜品	热菜	
菠菜杂粮粥	粥	主食	粥	
菠菜柿子鸡蛋汤	汤羹	菜品	汤羹	
菠菜炒油豆腐	热菜	菜品	热菜	
菠菜炒海红土豆片	热菜	菜品	热菜	
菠菜炒百叶	热菜	菜品	热菜	
菠菜炒粉丝	热菜	菜品	热菜	
菠菜炒粉条	热菜	菜品	热菜	
菠菜炒鸡蛋	热菜	菜品	热菜	
菠菜炒鸡蛋盖饭	盖浇饭	主食	饭	盖浇饭
菠菜炖扇贝肉	热菜	菜品	热菜	
菠菜热汤面	汤面	主食	面	汤面
菠菜煎饼卷菜	卷饼	主食	饼/囊/馍	卷饼
菠菜牛肉粥	粥	主食	粥	
菠菜牛肝菌汤	汤羹	菜品	汤羹	
菠菜猪肝粥	粥	主食	粥	
菠菜瘦肉粥	粥	主食	粥	
菠菜皮蛋瘦肉粥	粥	主食	粥	
菠菜粉丝汤	其他粉	主食	粉	其他粉
菠菜粉丝炒鸡蛋	热菜	菜品	热菜	
菠菜粉丝蛋汤	其他粉	主食	粉	其他粉
菠菜粉条炒鸡蛋	热菜	菜品	热菜	
菠菜肉丝粥	粥	主食	粥	
菠菜臊子汤面	汤面	主食	面	汤面
菠菜芙蓉汤	汤羹	菜品	汤羹	
菠菜花生粥	粥	主食	粥	
菠菜虾仁肉丝粥	粥	主食	粥	
菠菜蛋花汤	汤羹	菜品	汤羹	
菠菜蛋花牛肉粥	粥	主食	粥	
菠菜蛋花粥	粥	主食	粥	
菠菜豆腐汤	汤羹	菜品	汤羹	
菠菜鱼丸汤	汤羹	菜品	汤羹	
菠菜鸡蛋汤	热菜	菜品	热菜	
菠菜鸡蛋片汤	汤羹	菜品	汤羹	
菠菜鸡蛋疙瘩汤	汤羹	菜品	汤羹	
菠菜鸡蛋盖饭	盖浇饭	主食	饭	盖浇饭
菠萝银耳粥	粥	主食	粥	
菩提炒素斋	热菜	菜品	热菜	
萝卜丁小菜	凉菜	菜品	凉菜	
萝卜丁炒肉	热菜	菜品	热菜	
萝卜丝丸子汤	汤羹	菜品	汤羹	
萝卜丝全贝汤	汤羹	菜品	汤羹	
萝卜丝咸汤	汤羹	菜品	汤羹	
萝卜丝汆丸子汤	热菜	菜品	热菜	
萝卜丝汤厨面	汤面	主食	面	汤面
萝卜丝炒牛肉	热菜	菜品	热菜	
萝卜丝炒牛肉套餐	热菜	菜品	热菜	
萝卜丝炒粉	米线	主食	粉	米线
萝卜丝炒粉条	热菜	菜品	热菜	
萝卜丝炒肉	热菜	菜品	热菜	
萝卜丝炖墨鱼	热菜	菜品	热菜	
萝卜丝炖海米	热菜	菜品	热菜	
萝卜丝炖虾	热菜	菜品	热菜	
萝卜丝疙瘩汤	汤羹	菜品	汤羹	
萝卜丝粉条汤	其他粉	主食	粉	其他粉
萝卜丝羊肉丸子汤	汤羹	菜品	汤羹	
萝卜丝虾汤	汤羹	菜品	汤羹	
萝卜丝虾皮疙瘩汤	汤羹	菜品	汤羹	
萝卜丝鲜虾汤	汤羹	菜品	汤羹	
萝卜丝鲫鱼汤	汤羹	菜品	汤羹	
萝卜丸子汤	汤羹	菜品	汤羹	
萝卜丸子粉丝汤	其他粉	主食	粉	其他粉
萝卜全贝汤	汤羹	菜品	汤羹	
萝卜土豆丝黄豆芽汤	汤羹	菜品	汤羹	
萝卜小排汤	汤羹	菜品	汤羹	
萝卜带丝汤	汤羹	菜品	汤羹	
萝卜干炒毛豆	热菜	菜品	热菜	
萝卜干炒毛豆仁	热菜	菜品	热菜	
萝卜干炒蛋	热菜	菜品	热菜	
萝卜干炒豆	热菜	菜品	热菜	
萝卜干炒鸡蛋	热菜	菜品	热菜	
萝卜排骨汤	汤羹	菜品	汤羹	
萝卜排骨汤套餐饭	其他饭	主食	饭	其他饭
萝卜排骨瓦罐煨汤	汤羹	菜品	汤羹	
萝卜杂骨汤	汤羹	菜品	汤羹	
萝卜水丸汤	汤羹	菜品	汤羹	
萝卜海带汤	汤羹	菜品	汤羹	
萝卜清炖扇贝	热菜	菜品	热菜	
萝卜炒粉条	热菜	菜品	热菜	
萝卜炒鸡蛋	热菜	菜品	热菜	
萝卜炖三丁	热菜	菜品	热菜	
萝卜炖牛肉	热菜	菜品	热菜	
萝卜炖牛腩	热菜	菜品	热菜	
萝卜炖素鸡	热菜	菜品	热菜	
萝卜炖鲅鱼	热菜	菜品	热菜	
萝卜炖黄豆	热菜	菜品	热菜	
萝卜牛肉汤	汤羹	菜品	汤羹	
萝卜牛腩汤	汤羹	菜品	汤羹	
萝卜玉米排骨汤	汤羹	菜品	汤羹	
萝卜玉米汤	汤羹	菜品	汤羹	
萝卜瓜炖豆	热菜	菜品	热菜	
萝卜疙瘩汤	汤羹	菜品	汤羹	
萝卜粉丝丸子汤	其他粉	主食	粉	其他粉
萝卜粉丝小白菜	热菜	菜品	热菜	
萝卜粉丝汤	其他粉	主食	粉	其他粉
萝卜缨冷面	凉面	主食	面	凉面
萝卜羊肉粉丝汤	其他粉	主食	粉	其他粉
萝卜老鸭汤	汤羹	菜品	汤羹	
萝卜肉丸汤	汤羹	菜品	汤羹	
萝卜肉圆汤	汤羹	菜品	汤羹	
萝卜菜炒毛豆米	热菜	菜品	热菜	
萝卜菜芋艿汤	糖果	甜点	糖果	
萝卜骨头汤	汤羹	菜品	汤羹	
营养三黑粥	粥	主食	粥	
营养乌鸡汤	汤羹	菜品	汤羹	
营养乌鸡汤面	汤面	主食	面	汤面
营养二米粥	粥	主食	粥	
营养低脂鸡腿饭	其他饭	主食	饭	其他饭
营养全蔬菜面	汤面	主食	面	汤面
营养八宝粥	粥	主食	粥	
营养冬瓜排骨汤	汤羹	菜品	汤羹	
营养刀削面	其他面	主食	面	其他面
营养十谷米粥	粥	主食	粥	
营养南瓜粥	粥	主食	粥	
营养卤蛋盒饭	其他饭	主食	饭	其他饭
营养原味小米粥	粥	主食	粥	
营养双薯粥	粥	主食	粥	
营养味噌汤	汤羹	菜品	汤羹	
营养大碴粥	粥	主食	粥	
营养大米饭	白米饭	主食	饭	白米饭
营养娃娃菜	蔬菜类	火锅/串串/麻辣烫/色拉自选	配菜	蔬菜类
营养小米南瓜粥	粥	主食	粥	
营养小米粥	粥	主食	粥	
营养小馇粥	粥	主食	粥	
营养慢熬小米粥	粥	主食	粥	
营养杂米粥	粥	主食	粥	
营养杂粮粥	粥	主食	粥	
营养枣香黑米粥	粥	主食	粥	
营养海带汤	汤羹	菜品	汤羹	
营养海白菜	凉菜	菜品	凉菜	
营养牛骨头汤	汤羹	菜品	汤羹	
营养玉米排骨汤	汤羹	菜品	汤羹	
营养玉米汤	汤羹	菜品	汤羹	
营养玉米粥	粥	主食	粥	
营养玉米面粥	粥	主食	粥	
营养白米粥	粥	主食	粥	
营养白米粥配咸菜	粥	主食	粥	
营养白米饭	白米饭	主食	饭	白米饭
营养白粥送咸菜	粥	主食	粥	
营养皮蛋瘦肉粥	粥	主食	粥	
营养素菜粥	粥	主食	粥	
营养紫菜蛋花汤	汤羹	菜品	汤羹	
营养红枣八宝粥	粥	主食	粥	
营养红糖粥	粥	主食	粥	
营养绿豆粥	粥	主食	粥	
营养美味白粥	粥	主食	粥	
营养美容乌鸡汤	汤羹	菜品	汤羹	
营养老鸭汤	汤羹	菜品	汤羹	
营养腊八粥	粥	主食	粥	
营养茄汁面	汤面	主食	面	汤面
营养菌菇面	汤面	主食	面	汤面
营养菠菜面	其他菜品	其他	其他菜品	
营养萝卜排骨汤	汤羹	菜品	汤羹	
营养萝卜汤	汤羹	菜品	汤羹	
营养蔬菜粥	粥	主食	粥	
营养蛋花汤	汤羹	菜品	汤羹	
营养西红柿面	其他菜品	其他	其他菜品	
营养西红柿鸡蛋汤	汤羹	菜品	汤羹	
营养豆面粥	粥	主食	粥	
营养配餐粥	粥	主食	粥	
营养酸辣汤	汤羹	菜品	汤羹	
营养青菜粥	粥	主食	粥	
营养香菇排骨汤	汤羹	菜品	汤羹	
营养骨汤面	汤面	主食	面	汤面
营养鲍鱼鸽子粥	粥	主食	粥	
营养鳕鱼烩饭配汤	其他菜品	其他	其他菜品	
营养鸡蛋面	其他菜品	其他	其他菜品	
营养鸽子汤	汤羹	菜品	汤羹	
营养黑米八宝粥	粥	主食	粥	
营养黑米粥	粥	主食	粥	
葡萄紫米粥	粥	主食	粥	
葫芦炒木耳	热菜	菜品	热菜	
葫芦瓜蛋花汤	汤羹	菜品	汤羹	
葫芦瓜鸡蛋汤	汤羹	菜品	汤羹	
葱头木耳炒鸡蛋	热菜	菜品	热菜	
葱头炒木耳	热菜	菜品	热菜	
葱头炒鸡蛋盖饭	盖浇饭	主食	饭	盖浇饭
葱姜炒蛏子	热菜	菜品	热菜	
葱姜炒蛤蜊	热菜	菜品	热菜	
葱姜爆炒蛏子	热菜	菜品	热菜	
葱姜黄鱼面	汤面	主食	面	汤面
葱拌虾仁面	拌面	主食	面	拌面
葱油凉拌面	拌面	主食	面	拌面
葱油刀削面	其他面	主食	面	其他面
葱油包心芥菜	凉菜	菜品	凉菜	
葱油双菇拌面	拌面	主食	面	拌面
葱油双菇面	汤面	主食	面	汤面
葱油娃娃菜	热菜	菜品	热菜	
葱油拌手擀面	手擀面	主食	面	手擀面
葱油拌青菜	凉菜	菜品	凉菜	
葱油炒蚕豆	热菜	菜品	热菜	
葱油罗马生菜	蔬菜类	菜品	配菜	蔬菜类
葱油罗马菜	热菜	菜品	热菜	
葱油菌香炒饭	其他饭	主食	饭	其他饭
葱油西生菜	热菜	菜品	热菜	
葱油香菇面	汤面	主食	面	汤面
葱油鸡蛋拌面	拌面	主食	面	拌面
葱炒土鸡蛋	热菜	菜品	热菜	
葱炒山鸡蛋	热菜	菜品	热菜	
葱炒鸡蛋半份	热菜	菜品	热菜	
葱炒鸡蛋盖饭	盖浇饭	主食	饭	盖浇饭
葱炒鸡蛋米饭	炒饭	主食	饭	炒饭
葱炒鸡蛋花	热菜	菜品	热菜	
葱烧木耳炒肉	热菜	菜品	热菜	
葱烧木耳炒蛋	热菜	菜品	热菜	
葱烧豆腐盖饭	盖浇饭	主食	饭	盖浇饭
葱花刀削面	其他面	主食	面	其他面
葱花炒土豆	热菜	菜品	热菜	
葱花炒草鸡蛋	热菜	菜品	热菜	
葱花炒鸡蛋	热菜	菜品	热菜	
葱花爆蛋盖浇饭	盖浇饭	主食	饭	盖浇饭
葱花蛋炒饭	炒饭	主食	饭	炒饭
葱花蛋饼索面	汤面	主食	面	汤面
葱花酸汤面	汤面	主食	面	汤面
葱花饼夹菜	夹饼/夹馍	主食	饼/囊/馍	夹饼/夹馍
葱花香菜汤	汤羹	菜品	汤羹	
葱花鱼圆汤	汤羹	菜品	汤羹	
葱花鸡蛋炒饭	炒饭	主食	饭	炒饭
葱花鸡蛋盖饭	盖浇饭	主食	饭	盖浇饭
葱酱炒鸡蛋	热菜	菜品	热菜	
葱香刀削面	其他面	主食	面	其他面
葱香清汤面	汤面	主食	面	汤面
葱香疙瘩汤	汤羹	菜品	汤羹	
葱香蛋炒饭	炒饭	主食	饭	炒饭
蒜仔油麦菜	热菜	菜品	热菜	
蒜仔罗马生菜	热菜	菜品	热菜	
蒜台炒肉丝	热菜	菜品	热菜	
蒜台炒肉丝小清新	热菜	菜品	热菜	
蒜台炒肉套饭	其他饭	主食	饭	其他饭
蒜台炒鸡蛋	热菜	菜品	热菜	
蒜台香干炒肉丝	热菜	菜品	热菜	
蒜台鸡蛋炒饼	其他主食	主食	其他主食	
蒜台鸡蛋盖饭	盖浇饭	主食	饭	盖浇饭
蒜拌小菠菜	凉菜	菜品	凉菜	
蒜油罗马生菜	热菜	菜品	热菜	
蒜泥娃娃菜	热菜	菜品	热菜	
蒜泥小白菜	热菜	菜品	热菜	
蒜泥小青菜	热菜	菜品	热菜	
蒜泥拌菠菜	凉菜	菜品	凉菜	
蒜泥木耳菜	凉菜	菜品	凉菜	
蒜泥杭白菜	热菜	菜品	热菜	
蒜泥毛白菜菜	热菜	菜品	热菜	
蒜泥油麦菜	热菜	菜品	热菜	
蒜泥炒海带	热菜	菜品	热菜	
蒜泥炒空心菜	热菜	菜品	热菜	
蒜泥炒菠菜	热菜	菜品	热菜	
蒜泥炒豌豆尖	热菜	菜品	热菜	
蒜泥炒青菜	热菜	菜品	热菜	
蒜泥空心菜	热菜	菜品	热菜	
蒜泥茄子芹菜	热菜	菜品	热菜	
蒜泥蓬蒿菜	热菜	菜品	热菜	
蒜泥裙带菜	凉菜	菜品	凉菜	
蒜泥香菇菜	热菜	菜品	热菜	
蒜泥高山菜	热菜	菜品	热菜	
蒜泥鸡毛菜	热菜	菜品	热菜	
蒜泥龙须菜	凉菜	菜品	凉菜	
蒜炒地瓜叶	热菜	菜品	热菜	
蒜炒地瓜葉	热菜	菜品	热菜	
蒜炒油麦菜	热菜	菜品	热菜	
蒜炒西兰花	热菜	菜品	热菜	
蒜片油麦菜	热菜	菜品	热菜	
蒜粒小青菜	热菜	菜品	热菜	
蒜肉油麦菜	热菜	菜品	热菜	
蒜苔木耳炒肉	热菜	菜品	热菜	
蒜苔木耳炒鸡蛋	热菜	菜品	热菜	
蒜苔炒土豆条	热菜	菜品	热菜	
蒜苔炒肉丝	热菜	菜品	热菜	
蒜苔炒肉土豆条	热菜	菜品	热菜	
蒜苔炒肉小份	热菜	菜品	热菜	
蒜苔炒肉煲	热菜	菜品	热菜	
蒜苔炒肉片	热菜	菜品	热菜	
蒜苔炒豆腐干一份	热菜	菜品	热菜	
蒜苔炒鸡丝	热菜	菜品	热菜	
蒜苔炒鸡蛋	热菜	菜品	热菜	
蒜苔炒鸡蛋小份	热菜	菜品	热菜	
蒜苔炒鸡蛋盖浇	盖浇饭	主食	饭	盖浇饭
蒜苔炒鸡蛋盖饭	盖浇饭	主食	饭	盖浇饭
蒜苔生炒有机菜花	热菜	菜品	热菜	
蒜苔肉丝饭	盖浇饭	主食	饭	盖浇饭
蒜苔豆腐干肉丝盖浇饭	盖浇饭	主食	饭	盖浇饭
蒜苔青椒炒肉十米饭	其他菜品	其他	其他菜品	
蒜苔鸡肉丝炒菜	热菜	菜品	热菜	
蒜苔鸡蛋炒饼	其他主食	主食	其他主食	
蒜苔鸡蛋盖浇饭	盖浇饭	主食	饭	盖浇饭
蒜苔鸡蛋盖饭	盖浇饭	主食	饭	盖浇饭
蒜苔鸡蛋素炒饼	其他主食	主食	其他主食	
蒜苗叶炒鸡蛋	热菜	菜品	热菜	
蒜苗炒肉丝	热菜	菜品	热菜	
蒜苗炒肉半盘	热菜	菜品	热菜	
蒜苗炒肉片	热菜	菜品	热菜	
蒜苗炒蚕豆	热菜	菜品	热菜	
蒜苗炒豆皮	热菜	菜品	热菜	
蒜苗炒面皮	凉皮	主食	凉皮	
蒜苗炒鸡蛋	热菜	菜品	热菜	
蒜苗炒鸡蛋盖饭	盖浇饭	主食	饭	盖浇饭
蒜苗肉丝炒豆干	热菜	菜品	热菜	
蒜茄子小菜	凉菜	菜品	凉菜	
蒜茸娃娃菜	热菜	菜品	热菜	
蒜茸时令蔬菜	热菜	菜品	热菜	
蒜茸油麦菜	热菜	菜品	热菜	
蒜茸油麦菜盖饭	盖浇饭	主食	饭	盖浇饭
蒜茸清炒荷兰豆	热菜	菜品	热菜	
蒜茸灼生菜	其他菜品	其他	其他菜品	
蒜茸炒娃娃菜	热菜	菜品	热菜	
蒜茸炒油麦菜	热菜	菜品	热菜	
蒜茸炒西兰花	热菜	菜品	热菜	
蒜茸空心菜	热菜	菜品	热菜	
蒜茸粉丝娃娃菜	热菜	菜品	热菜	
蒜茸粉丝蒸娃娃菜	热菜	菜品	热菜	
蒜茸粉丝蒸白菜	热菜	菜品	热菜	
蒜茸罗马生菜	热菜	菜品	热菜	
蒜茸鸡毛菜	热菜	菜品	热菜	
蒜蓉圆生菜	热菜	菜品	热菜	
蒜蓉娃娃菜	蔬菜类	菜品	蔬菜类	
蒜蓉小油菜	热菜	菜品	热菜	
蒜蓉小白菜	热菜	菜品	热菜	
蒜蓉小青菜	热菜	菜品	热菜	
蒜蓉尤麦菜	热菜	菜品	热菜	
蒜蓉木耳盖饭	盖浇饭	主食	饭	盖浇饭
蒜蓉油麦菜	热菜	菜品	热菜	
蒜蓉油麦菜盖浇饭	盖浇饭	主食	饭	盖浇饭
蒜蓉炒凉瓜	热菜	菜品	热菜	
蒜蓉炒大白菜	热菜	菜品	热菜	
蒜蓉炒娃娃菜	热菜	菜品	热菜	
蒜蓉炒时蔬	热菜	菜品	热菜	
蒜蓉炒毛豆	热菜	菜品	热菜	
蒜蓉炒油麦菜	热菜	菜品	热菜	
蒜蓉炒生菜	热菜	菜品	热菜	
蒜蓉炒番薯叶	热菜	菜品	热菜	
蒜蓉炒空心菜	热菜	菜品	热菜	
蒜蓉炒芥兰	热菜	菜品	热菜	
蒜蓉炒芥兰苗	热菜	菜品	热菜	
蒜蓉炒茼蒿	热菜	菜品	热菜	
蒜蓉炒菜心	热菜	菜品	热菜	
蒜蓉炒菜心例牌	热菜	菜品	热菜	
蒜蓉炒西兰花	热菜	菜品	热菜	
蒜蓉炒西生菜	热菜	菜品	热菜	
蒜蓉炒青菜	热菜	菜品	热菜	
蒜蓉秋葵炒山药	热菜	菜品	热菜	
蒜蓉空心菜	热菜	菜品	热菜	
蒜蓉竹叶菜	热菜	菜品	热菜	
蒜蓉粉丝娃娃菜	热菜	菜品	热菜	
蒜蓉粉丝蒸娃娃菜	热菜	菜品	热菜	
蒜蓉粉丝蟹肉娃娃菜	热菜	菜品	热菜	
蒜蓉素炒苦瓜	热菜	菜品	热菜	
蒜蓉红苋菜	热菜	菜品	热菜	
蒜蓉罗马生菜	热菜	菜品	热菜	
蒜蓉茼蒿菜	热菜	菜品	热菜	
蒜蓉蒸娃娃菜	热菜	菜品	热菜	
蒜蓉蚝油生菜	热菜	菜品	热菜	
蒜蓉裙带菜	凉菜	菜品	凉菜	
蒜蓉西兰花饭	盖浇饭	主食	饭	盖浇饭
蒜蓉通心菜	热菜	菜品	热菜	
蒜蓉金菇娃娃菜	热菜	菜品	热菜	
蒜蓉鸡毛菜	热菜	菜品	热菜	
蒜薹土豆盖饭	盖浇饭	主食	饭	盖浇饭
蒜薹炒皮肚	热菜	菜品	热菜	
蒜薹炒肉丝	热菜	菜品	热菜	
蒜薹炒鸡丝	热菜	菜品	热菜	
蒜薹炒鸡蛋	热菜	菜品	热菜	
蒜薹鸡蛋盖饭	盖浇饭	主食	饭	盖浇饭
蒜香圆白菜	热菜	菜品	热菜	
蒜香小青菜	热菜	菜品	热菜	
蒜香橄榄菜	热菜	菜品	热菜	
蒜香油麦菜	蔬菜类	菜品	配菜	蔬菜类
蒜香空心菜	热菜	菜品	热菜	
蒜香耗油生菜	热菜	菜品	热菜	
蒜香茄子盖饭	盖浇饭	主食	饭	盖浇饭
蒜黄炒肉丝	热菜	菜品	热菜	
蒜黄炒鸡蛋	热菜	菜品	热菜	
蒜黄香干炒肉丝	热菜	菜品	热菜	
蒜黄鸡蛋盖浇饭	盖浇饭	主食	饭	盖浇饭
蒜黄鸡蛋盖饭	盖浇饭	主食	饭	盖浇饭
蒲瓜炒虾皮	热菜	菜品	热菜	
蒸馄饨加汤	其他菜品	其他	其他菜品	
蒸鲜甜潮汕巴浪鱼送酸菜	其他菜品	其他	其他菜品	
蒿菜豆腐汤	汤羹	菜品	汤羹	
蓝港大拌菜	凉菜	菜品	凉菜	
蔓越莓枸杞红枣红糖粥	粥	主食	粥	
蔓越莓桃胶炖银耳	其他甜品	甜点	其他甜品	
蔚县营养小米粥	粥	主食	粥	
蔣爆圆白菜	热菜	菜品	热菜	
蔬菜乌冬面	乌冬面	主食	面	乌冬面
蔬菜什锦粥	粥	主食	粥	
蔬菜刀削面	其他面	主食	面	其他面
蔬菜扇贝粥	粥	主食	粥	
蔬菜汤乌冬面	乌冬面	主食	面	乌冬面
蔬菜清汤面	汤面	主食	面	汤面
蔬菜炒米粉	米线	主食	粉	米线
蔬菜炒米线	米线	主食	粉	米线
蔬菜炒芋头	热菜	菜品	热菜	
蔬菜炒面加蛋	炒面	主食	面	炒面
蔬菜热汤面	汤面	主食	面	汤面
蔬菜牛肉炒饭	炒饭	主食	饭	炒饭
蔬菜牛肉粥	粥	主食	粥	
蔬菜牛肉蛋花粥	粥	主食	粥	
蔬菜疙瘩汤	汤羹	菜品	汤羹	
蔬菜瘦肉粥	粥	主食	粥	
蔬菜皮蛋瘦肉粥	粥	主食	粥	
蔬菜皮蛋粥	粥	主食	粥	
蔬菜砂锅有面全菜不要点点了也放面	其他菜品	其他	其他菜品	
蔬菜粗粮面	米线	主食	面	米线
蔬菜精肉粥	粥	主食	粥	
蔬菜紫菜包饭	寿司	主食	饭	其他饭
蔬菜罐罐面	汤面	主食	面	汤面
蔬菜肉丝粥	粥	主食	粥	
蔬菜肉沫粥	粥	主食	粥	
蔬菜胚芽米粥	粥	主食	粥	
蔬菜荞麦冷面	凉面	主食	面	凉面
蔬菜菌菇粥	粥	主食	粥	
蔬菜营养嫩豆腐汤	汤羹	菜品	汤羹	
蔬菜营养粥	粥	主食	粥	
蔬菜虾仁粥	粥	主食	粥	
蔬菜蛋炒饭	炒饭	主食	饭	炒饭
蔬菜蛋炒饼	其他主食	主食	其他主食	
蔬菜蛋花汤	汤羹	菜品	汤羹	
蔬菜蛋花粥	粥	主食	粥	
蔬菜蟹肉乌冬面	乌冬面	主食	面	乌冬面
蔬菜课代表小油菜	蔬菜类	火锅/串串/麻辣烫/色拉自选	配菜	蔬菜类
蔬菜豆腐汤	汤羹	菜品	汤羹	
蔬菜贡丸汤	汤羹	菜品	汤羹	
蔬菜香米粥	粥	主食	粥	
蔬菜香菇砂锅粥	粥	主食	粥	
蔬菜鸡肉粥	粥	主食	粥	
蔬菜鸡蛋汤	汤羹	菜品	汤羹	
蔬菜鸡蛋炒米线	米线	主食	粉	米线
蔬菜鸡蛋炒面	炒面	主食	面	炒面
蔬菜鸡蛋炒饭	炒饭	主食	饭	炒饭
蔬菜龙须面	汤面	主食	面	汤面
蕃茄手擀面	手擀面	主食	面	手擀面
蕃茄汆圆汤	汤羹	菜品	汤羹	
蕃茄炒嫩蛋	热菜	菜品	热菜	
蕃茄炒田园菜花	热菜	菜品	热菜	
蕃茄炒蛋盖浇饭	盖浇饭	主食	饭	盖浇饭
蕃茄炒蛋盖饭	盖浇饭	主食	饭	盖浇饭
蕃茄炒蛋饭	盖浇饭	主食	饭	盖浇饭
蕃茄炒鸡蛋	热菜	菜品	热菜	
蕃茄炖牛肉	热菜	菜品	热菜	
蕃茄烧花菜	热菜	菜品	热菜	
蕃茄煎蛋汤	汤羹	菜品	汤羹	
蕃茄牛肉面	汤面	主食	面	汤面
蕃茄牛肉饭	盖浇饭	主食	饭	盖浇饭
蕃茄肉丝蛋花汤	汤羹	菜品	汤羹	
蕃茄肉片汤	汤羹	菜品	汤羹	
蕃茄蛋炒刀削面	其他面	主食	面	其他面
蕃茄青菜蛋炒饭	炒饭	主食	饭	炒饭
蕃茄鸡蛋打卤面	盖浇面	主食	面	盖浇面
蕃茄鸡蛋汤	汤羹	菜品	汤羹	
蕃茄鸡蛋炒面	炒面	主食	面	炒面
蕃茄鸡蛋盖饭	盖浇饭	主食	饭	盖浇饭
蕃茄鸡蛋肉丝汤	汤羹	菜品	汤羹	
蕃茄鸡蛋面	汤面	主食	面	汤面
薄皮椒炒鸡蛋	热菜	菜品	热菜	
薏仁生态糙米饭	白米饭	主食	饭	白米饭
薏仁米燕麦粥	粥	主食	粥	
薏仁红豆汤	糖水/炖品	甜点	糖水/炖品	
薏米大麦粥	粥	主食	粥	
薏米煨乌鸡汤	汤羹	菜品	汤羹	
薏米碴子粥	粥	主食	粥	
薏米红豆汤	糖水/炖品	甜点	糖水/炖品	
薏米红豆粥	粥	主食	粥	
薏米绿豆百合粥	粥	主食	粥	
薏米绿豆粥	粥	主食	粥	
薏米绿豆莲子粥	粥	主食	粥	
薏米茯苓芡实粥	粥	主食	粥	
薏米银耳淮山汤	糖水/炖品	甜点	糖水/炖品	
薏米黑米粥	粥	主食	粥	
藕尖炒虾仁	热菜	菜品	热菜	
藕断丝连丝瓜炒蛋	热菜	菜品	热菜	
藕粉莲子粥	粥	主食	粥	
藜麦南瓜粥	粥	主食	粥	
藜麦奥尔良沙拉饭	健康餐	色拉轻食	健康餐	
藜麦小米粥	粥	主食	粥	
藜麦虫草花粥	粥	主食	粥	
藠头炒莴笋	热菜	菜品	热菜	
蘑菇乌冬面	乌冬面	主食	面	乌冬面
蘑菇什锦面	汤面	主食	面	汤面
蘑菇小青菜	热菜	菜品	热菜	
蘑菇炒油菜	热菜	菜品	热菜	
蘑菇炒肉丝	热菜	菜品	热菜	
蘑菇炒肉片	热菜	菜品	热菜	
蘑菇炒肉盖浇饭	盖浇饭	主食	饭	盖浇饭
蘑菇炒肉盖饭	盖浇饭	主食	饭	盖浇饭
蘑菇炒芹菜	热菜	菜品	热菜	
蘑菇炒青菜	热菜	菜品	热菜	
蘑菇炒鸡蛋	热菜	菜品	热菜	
蘑菇炖豆腐	热菜	菜品	热菜	
蘑菇烧芹菜	热菜	菜品	热菜	
蘑菇素鸡面	汤面	主食	面	汤面
蘑菇肉丝粥	粥	主食	粥	
蘑菇肉丝青菜汤	汤羹	菜品	汤羹	
蘑菇肉丝面	汤面	主食	面	汤面
蘑菇肉汤面	汤面	主食	面	汤面
蘑菇肉片汤	汤羹	菜品	汤羹	
蘑菇蔬菜粥	粥	主食	粥	
蘑菇豆瓣毛圆汤	汤羹	菜品	汤羹	
蘑菇雷笋炒肉片	热菜	菜品	热菜	
蘑菇青菜汤	汤羹	菜品	汤羹	
蘑菇青菜蛋汤	汤羹	菜品	汤羹	
蘑菇青菜饭	盖浇饭	主食	饭	盖浇饭
蘑菇鸡蛋汤	汤羹	菜品	汤羹	
蘸水苦菜汤	汤羹	菜品	汤羹	
虎头鱼豆腐汤	热菜	菜品	热菜	
虫草滑鸡滋补粥	粥	主食	粥	
虫草花乌鸡汤	汤羹	菜品	汤羹	
虫草花干贝虾仁粥	粥	主食	粥	
虫草花拌菠菜	凉菜	菜品	凉菜	
虫草花枸杞炖瘦肉	汤羹	菜品	汤羹	
虫草花炖乌鸡	汤羹	菜品	汤羹	
虫草花炖乌鸡汤	汤羹	菜品	汤羹	
虫草花炖土家鸡	热菜	菜品	热菜	
虫草花炖瘦肉	汤羹	菜品	汤羹	
虫草花炖瘦肉汤	汤羹	菜品	汤羹	
虫草花炖竹荪	热菜	菜品	热菜	
虫草花炖鸭	汤羹	菜品	汤羹	
虫草花老鸭汤	汤羹	菜品	汤羹	
虫草花肉片粥	粥	主食	粥	
虫草花花乌鸡汤	汤羹	菜品	汤羹	
虫草花萝卜龙骨炖盅汤	汤羹	菜品	汤羹	
虫草花鸡肉粥	粥	主食	粥	
虫草花鸭汤	汤羹	菜品	汤羹	
虫草花鸽子汤	汤羹	菜品	汤羹	
虫草鲜菌汤	汤羹	菜品	汤羹	
虾仁丸子裙带菜	热菜	菜品	热菜	
虾仁冬瓜汤	汤羹	菜品	汤羹	
虾仁大头菜	热菜	菜品	热菜	
虾仁娃娃菜	热菜	菜品	热菜	
虾仁干贝粥	粥	主食	粥	
虾仁扒油菜	热菜	菜品	热菜	
虾仁时件面	汤面	主食	面	汤面
虾仁木耳炒滑蛋	热菜	菜品	热菜	
虾仁木耳炒鸡蛋	热菜	菜品	热菜	
虾仁滑蛋粥	粥	主食	粥	
虾仁滑蛋饭	盖浇饭	主食	饭	盖浇饭
虾仁火腿粥	粥	主食	粥	
虾仁火腿青菜粥	粥	主食	粥	
虾仁炒合菜	热菜	菜品	热菜	
虾仁炒四季豆	热菜	菜品	热菜	
虾仁炒土鸡蛋	热菜	菜品	热菜	
虾仁炒小白菜	热菜	菜品	热菜	
虾仁炒山药	热菜	菜品	热菜	
虾仁炒滑蛋	热菜	菜品	热菜	
虾仁炒炒蛋	其他菜品	其他	其他菜品	
虾仁炒玉米粒	热菜	菜品	热菜	
虾仁炒瓜片	热菜	菜品	热菜	
虾仁炒疙瘩	热菜	菜品	面	炒面
虾仁炒蛋汤	汤羹	菜品	汤羹	
虾仁炒西芹	热菜	菜品	热菜	
虾仁炒青豆	热菜	菜品	热菜	
虾仁炒馇子	热菜	菜品	热菜	
虾仁炒鱼片	热菜	菜品	热菜	
虾仁炒鸡蛋	热菜	菜品	热菜	
虾仁烧白菜	热菜	菜品	热菜	
虾仁烧菠菜	热菜	菜品	热菜	
虾仁猪肚粥	粥	主食	粥	
虾仁玉米炒饭	炒饭	主食	饭	炒饭
虾仁玉米砂锅粥	粥	主食	粥	
虾仁玉米粥	粥	主食	粥	
虾仁番茄炒蛋	热菜	菜品	热菜	
虾仁番茄炒鸡蛋	热菜	菜品	热菜	
虾仁瘦肉粥	粥	主食	粥	
虾仁皮蛋瘦肉营养粥	粥	主食	粥	
虾仁竹笙汤	热菜	菜品	热菜	
虾仁菜心胚芽米粥	粥	主食	粥	
虾仁蛋炒饭	炒饭	主食	饭	炒饭
虾仁蛋花粥	粥	主食	粥	
虾仁蛤蜊粥	粥	主食	粥	
虾仁蟹柳杂粮波奇饭	健康餐	色拉轻食	健康餐	
虾仁西兰花饭	其他饭	主食	饭	其他饭
虾仁西芹小炒	热菜	菜品	热菜	
虾仁豆腐汤	汤羹	菜品	汤羹	
虾仁青菜汤	汤羹	菜品	汤羹	
虾仁青菜粥	粥	主食	粥	
虾仁香菇炒饭	炒饭	主食	饭	炒饭
虾仁香菇面	汤面	主食	面	汤面
虾仁鱼片粥	粥	主食	粥	
虾仁鱼片豆腐面	汤面	主食	面	汤面
虾仁鲜汁煲饭	煲仔饭	主食	饭	煲仔饭
虾仁鲜蔬炒饭	炒饭	主食	饭	炒饭
虾仁鲜蔬面	盖浇面	主食	面	盖浇面
虾仁鸡蛋炒叉子	炒面	主食	面	炒面
虾仁鸡蛋炒小白菜	热菜	菜品	热菜	
虾仁鸡蛋炒饭	炒饭	主食	饭	炒饭
虾做的疙瘩汤	汤羹	菜品	汤羹	
虾和菜炒在一起	热菜	菜品	热菜	
虾块炒白菜	热菜	菜品	热菜	
虾干炝炒莲花白	热菜	菜品	热菜	
虾干蚬肉炖茄子	热菜	菜品	热菜	
虾滑白菜炖豆腐	热菜	菜品	热菜	
虾滑蔬菜汤面	汤面	主食	面	汤面
虾爬肉炒卷心菜	热菜	菜品	热菜	
虾爬肉炒甘蓝粉	热菜	菜品	热菜	
虾皮包心菜	热菜	菜品	热菜	
虾皮卷心菜	热菜	菜品	热菜	
虾皮圆白菜疙瘩汤	汤羹	菜品	汤羹	
虾皮大头菜	热菜	菜品	热菜	
虾皮小白菜	饺子	菜品	饺子	
虾皮炒小白菜	热菜	菜品	热菜	
虾皮炒甘蓝粉	热菜	菜品	热菜	
虾皮炒莴笋	热菜	菜品	热菜	
虾皮炒蒲瓜	热菜	菜品	热菜	
虾皮炒饽饽	馒头	菜品	馒头	
虾皮炒鸡蛋	热菜	菜品	热菜	
虾皮甘蓝炒粉	米线	主食	粉	米线
虾皮疙瘩汤	汤羹	菜品	汤羹	
虾皮白菜炖冻豆腐	热菜	菜品	热菜	
虾皮白菜疙瘩汤	汤羹	菜品	汤羹	
虾皮粉丝小白菜	热菜	菜品	热菜	
虾皮粉丝洋白菜	热菜	菜品	热菜	
虾皮粉小白菜	热菜	菜品	热菜	
虾皮紫菜汤	汤羹	菜品	汤羹	
虾皮紫菜蛋汤	汤羹	菜品	汤羹	
虾皮紫菜蛋花汤	汤羹	菜品	汤羹	
虾皮菠菜汤	汤羹	菜品	汤羹	
虾皮菠菜粥	粥	主食	粥	
虾皮蚝油生菜	热菜	菜品	热菜	
虾皮青菜疙瘩汤	汤羹	菜品	汤羹	
虾皮韭菜炒饽饽	馒头	主食	馒头	
虾米炒冬瓜	热菜	菜品	热菜	
虾米炒荠菜	热菜	菜品	热菜	
虾米炒钙菜	热菜	菜品	热菜	
虾米炒韭菜	热菜	菜品	热菜	
虾米煮鸡粥	粥	主食	粥	
虾米紫菜汤	汤羹	菜品	汤羹	
虾米紫菜蛋汤	汤羹	菜品	汤羹	
虾米紫菜蛋花汤	汤羹	菜品	汤羹	
虾米肉碎蒸蛋饭	盖浇饭	主食	饭	盖浇饭
虾茸草菇白菜	热菜	菜品	热菜	
虾菇削骨肉粥	粥	主食	粥	
虾酱炒花菜	热菜	菜品	热菜	
虾酱空心菜	热菜	菜品	热菜	
虾酱鸡蛋炒莲白	热菜	菜品	热菜	
蚌肉鸡毛菜	热菜	菜品	热菜	
蚕肉小白菜	热菜	菜品	热菜	
蚕豆木耳炒鸡蛋	热菜	菜品	热菜	
蚕豆炒肉丝	热菜	菜品	热菜	
蚕豆米土鸡蛋汤	汤羹	菜品	汤羹	
蚕豆米炒肉丝	热菜	菜品	热菜	
蚕豆米炒鸡蛋	热菜	菜品	热菜	
蚝干一品粥	粥	主食	粥	
蚝油包心菜	热菜	菜品	热菜	
蚝油双菇面	盖浇面	主食	面	盖浇面
蚝油唐生菜	热菜	菜品	热菜	
蚝油圆生菜	热菜	菜品	热菜	
蚝油娃娃菜	热菜	菜品	热菜	
蚝油生菜盖饭	盖浇饭	主食	饭	盖浇饭
蚝油罗马生菜	热菜	菜品	热菜	
蚝油草菇面	盖浇面	主食	面	盖浇面
蚝油菌菇饭	盖浇饭	主食	饭	盖浇饭
蚝油西生菜	热菜	菜品	热菜	
蚝油香菇青菜	热菜	菜品	热菜	
蚬子拌菠菜	凉菜	菜品	凉菜	
蚬子炖茄子	热菜	菜品	热菜	
蚬子肉炖小白菜	热菜	菜品	热菜	
蚬子豆腐汤	汤羹	菜品	汤羹	
蛋加瘦肉炒粉	浇头	其他	浇头	
蛋炒手擀面	炒面	主食	面	炒面
蛋炒拨烂子	炒面	主食	面	炒面
蛋炒荞面摊饼	炒面	主食	面	炒面
蛋炒豆面抿尖	炒面	主食	面	炒面
蛋皮肉丝面	盖浇面	主食	面	盖浇面
蛋花玉米粥	粥	主食	粥	
蛋花疙瘩汤	汤羹	菜品	汤羹	
蛋花紫菜汤	汤羹	菜品	汤羹	
蛋花虾仁汤	汤羹	菜品	汤羹	
蛋花青菜粥	粥	主食	粥	
蛋花鲜虾粥	粥	主食	粥	
蛋饺粉丝白菜	热菜	菜品	热菜	
蛋黄炒花菜	热菜	菜品	热菜	
蛎肉豆腐汤	汤羹	菜品	汤羹	
蛎虾豆腐汤	汤羹	菜品	汤羹	
蛏子炒姜葱	热菜	菜品	热菜	
蛏子豆腐汤	汤羹	菜品	汤羹	
蛏煎蛋豆芽汤	汤羹	菜品	汤羹	
蛤叉小白菜	饺子	主食	饺子	
蛤喇肉炒小白菜	热菜	菜品	热菜	
蛤肉小白菜	热菜	菜品	热菜	
蛤肉炒芹菜	热菜	菜品	热菜	
蛤蜊冬瓜汤	汤羹	菜品	汤羹	
蛤蜊噶哒汤	汤羹	菜品	汤羹	
蛤蜊小白菜	热菜	菜品	热菜	
蛤蜊疙瘩汤	汤羹	菜品	汤羹	
蛤蜊肉小白菜	热菜	菜品	热菜	
蛤蜊肉小白菜炒蛋	热菜	菜品	热菜	
蛤蜊肉炒娃娃菜	热菜	菜品	热菜	
蛤蜊肉炒鸡蛋	热菜	菜品	热菜	
蛤蜊肉疙瘩汤	汤羹	菜品	汤羹	
蛤蜊肉粉丝小白菜	热菜	菜品	热菜	
蛤蜊芸豆面	汤面	主食	面	汤面
蛤蜊蔬汁疙瘩汤	汤羹	菜品	汤羹	
蛤蜊豆腐汤	汤羹	菜品	汤羹	
蛰头拌娃娃菜	凉菜	菜品	凉菜	
蛰皮娃娃菜	凉菜	菜品	凉菜	
蛰皮粉丝娃娃菜	凉菜	菜品	凉菜	
蜂蜜大枣粥	粥	主食	粥	
蜂蜜牛奶芝麻粥	粥	主食	粥	
蜆肉疙瘩汤	汤羹	菜品	面	其他面
蜜枣绿豆汤	糖水/炖品	甜点	糖水/炖品	
蜜汁圆白菜	热菜	菜品	热菜	
蜜汁红豆粥	粥	主食	粥	
融味大拌菜	凉菜	菜品	凉菜	
螺丝椒炒鸡蛋	热菜	菜品	热菜	
螺丝椒炒鸡蛋盖浇饭	木桶饭	主食	饭	木桶饭
蟹味菇炒肉	热菜	菜品	热菜	
蟹味菇炒肉丝	热菜	菜品	热菜	
蟹柳粉丝娃娃菜	热菜	菜品	热菜	
蟹田大米粥	粥	主食	粥	
蟹粉娃娃菜	热菜	菜品	热菜	
蟹肉棒炒蛋	热菜	菜品	热菜	
蠔干肉丝粥	粥	主食	粥	
血糯红豆粥	粥	主食	粥	
血糯营养八宝粥	粥	主食	粥	
补气山药粥	粥	主食	粥	
补益海参汤	汤羹	菜品	汤羹	
补肝益气粥	粥	主食	粥	
补脑黄鳝粥	粥	主食	粥	
补血南瓜粥	粥	主食	粥	
补血新鲜猪肝生菜粥	粥	主食	粥	
补血黑米粥	粥	主食	粥	
补铁牛肉胡萝卜烩饭配汤	其他菜品	其他	其他菜品	
裙带菜乌冬面	乌冬面	主食	面	乌冬面
裙带菜味噌汤	汤羹	菜品	汤羹	
裙带菜炖豆腐	热菜	菜品	热菜	
裙带菜蛋汤	汤羹	菜品	汤羹	
裙带菜蛋花汤	汤羹	菜品	汤羹	
裙带菜豆腐汤	汤羹	菜品	汤羹	
裙带菜鸡蛋豆腐汤	汤羹	菜品	汤羹	
裙带蛋花汤	汤羹	菜品	汤羹	
裹面素莲菜	蔬菜类	烧烤	蔬菜类	
襄阳豆腐海带面	汤面	主食	面	汤面
襄阳豆腐面	汤面	主食	面	汤面
西兰花小炒	热菜	菜品	热菜	
西兰花小炒小份	热菜	菜品	热菜	
西兰花木耳炒香菇	热菜	菜品	热菜	
西兰花清炒	热菜	菜品	热菜	
西兰花炒山药	热菜	菜品	热菜	
西兰花炒手扒虾仁	热菜	菜品	热菜	
西兰花炒木耳	热菜	菜品	热菜	
西兰花炒杂菌	热菜	菜品	热菜	
西兰花炒牛肉	热菜	菜品	热菜	
西兰花炒肉	热菜	菜品	热菜	
西兰花炒肉片	热菜	菜品	热菜	
西兰花炒肉片饭	盖浇饭	主食	饭	盖浇饭
西兰花炒虾仁	热菜	菜品	热菜	
西兰花炒虾仁澳带	热菜	菜品	热菜	
西兰花炒香菇	热菜	菜品	热菜	
西兰花炒鸡胸肉	热菜	菜品	热菜	
西兰花炒鸡蛋	热菜	菜品	热菜	
西兰花虾仁炒木耳	热菜	菜品	热菜	
西兰花豆腐鸡蛋汤	汤羹	菜品	汤羹	
西北婆姨手擀面	手擀面	主食	面	手擀面
西北浇汁莜面	盖浇面	主食	面	盖浇面
西域大拌菜	凉菜	菜品	凉菜	
西山小米粥	粥	主食	粥	
西洋参乌鸡汤	汤羹	菜品	汤羹	
西洋参乳鸽汤	汤羹	菜品	汤羹	
西洋参枸杞炖蛋	糖水/炖品	甜点	糖水/炖品	
西洋参炖乌鸡汤	汤羹	菜品	汤羹	
西洋参炖鸽子	汤羹	菜品	汤羹	
西洋参鸽子汤	汤羹	菜品	汤羹	
西洋参黑鱼汤	汤羹	菜品	汤羹	
西洋菜肉片汤	汤羹	菜品	汤羹	
西湖小馄炖	馄饨	主食	馄饨	
西湖纯菜汤	汤羹	菜品	汤羹	
西湖莼菜汤	汤羹	菜品	汤羹	
西紅柿炒蛋	热菜	菜品	热菜	
西红市炒蛋	热菜	菜品	热菜	
西红市蛋汤	汤羹	菜品	汤羹	
西红市鸡蛋汤	汤羹	菜品	汤羹	
西红市鸡蛋紫菜汤	汤羹	菜品	汤羹	
西红市鸡蛋面	汤面	主食	面	汤面
西红杮炒蛋盖饭	热菜	菜品	热菜	
西红杮炒鸡蛋	热菜	菜品	热菜	
西红杮鸡蛋炒刀削面	其他面	主食	面	其他面
西红柿丸子汤	汤羹	菜品	汤羹	
西红柿凉面	凉面	主食	面	凉面
西红柿刀削汤面	其他面	主食	面	其他面
西红柿刀削面	其他面	主食	面	其他面
西红柿卤面	盖浇面	主食	面	盖浇面
西红柿土豆牛肉盖饭	盖浇饭	主食	饭	盖浇饭
西红柿土豆疙瘩汤	汤羹	菜品	汤羹	
西红柿土鸡蛋汤	汤羹	菜品	汤羹	
西红柿手扞面	盖浇面	主食	面	盖浇面
西红柿手擀面	手擀面	主食	面	手擀面
西红柿手擀面汤	汤面	主食	面	汤面
西红柿打卤面	盖浇面	主食	面	盖浇面
西红柿拌汤	汤羹	菜品	汤羹	
西红柿拌面	拌面	主食	面	拌面
西红柿挂面汤	汤面	主食	面	汤面
西红柿旦汤	汤羹	菜品	汤羹	
西红柿木耳炖牛腩	热菜	菜品	热菜	
西红柿毛园汤	汤羹	菜品	汤羹	
西红柿毛圆汤	汤羹	菜品	汤羹	
西红柿氽元汤	汤羹	菜品	汤羹	
西红柿汆元汤	热菜	菜品	热菜	
西红柿汆肉汤	汤羹	菜品	汤羹	
西红柿汤面	汤面	主食	面	汤面
西红柿浇汁莜面	盖浇面	主食	面	盖浇面
西红柿炒土豆片	热菜	菜品	热菜	
西红柿炒土豆片盖饭	盖浇饭	主食	饭	盖浇饭
西红柿炒土鸡蛋	热菜	菜品	热菜	
西红柿炒山药	热菜	菜品	热菜	
西红柿炒扇贝	热菜	菜品	热菜	
西红柿炒无抗鸡蛋	热菜	菜品	热菜	
西红柿炒米粉	米线	主食	粉	米线
西红柿炒花菜	热菜	菜品	热菜	
西红柿炒茄丝	热菜	菜品	热菜	
西红柿炒莜面	炒面	主食	面	炒面
西红柿炒菜花	热菜	菜品	热菜	
西红柿炒蛋	盖浇饭	菜品	饭	盖浇饭
西红柿炒蛋丨妈妈味	热菜	菜品	热菜	
西红柿炒蛋丨谁能不爱	热菜	菜品	热菜	
西红柿炒蛋十青椒炒肉	热菜	菜品	热菜	
西红柿炒蛋大碗饭	盖浇饭	主食	饭	盖浇饭
西红柿炒蛋套餐	其他菜品	其他	其他菜品	
西红柿炒蛋小份	热菜	菜品	热菜	
西红柿炒蛋小碗菜	热菜	菜品	热菜	
西红柿炒蛋木桶饭	木桶饭	主食	饭	木桶饭
西红柿炒蛋炒蛋	热菜	菜品	热菜	
西红柿炒蛋盖浇米饭	盖浇饭	主食	饭	盖浇饭
西红柿炒蛋盖浇面	盖浇面	主食	面	盖浇面
西红柿炒蛋盖浇饭	盖浇饭	主食	饭	盖浇饭
西红柿炒蛋盖浇饭外卖	热菜	菜品	热菜	
西红柿炒蛋盖码饭	盖浇饭	主食	饭	盖浇饭
西红柿炒蛋盖米	盖浇饭	主食	饭	盖浇饭
西红柿炒蛋盖饭	盖浇饭	主食	饭	盖浇饭
西红柿炒蛋送米饭	其他菜品	其他	其他菜品	
西红柿炒蛋面	汤面	主食	面	汤面
西红柿炒蛋饭	盖浇饭	主食	饭	盖浇饭
西红柿炒蛋饭木桶饭	木桶饭	主食	饭	木桶饭
西红柿炒鸡蛋	热菜	菜品	热菜	
西红柿炒鸡蛋一人份	热菜	菜品	热菜	
西红柿炒鸡蛋十白米饭	其他菜品	其他	其他菜品	
西红柿炒鸡蛋大份	热菜	菜品	热菜	
西红柿炒鸡蛋套餐	其他菜品	其他	其他菜品	
西红柿炒鸡蛋套餐十汤	其他菜品	其他	其他菜品	
西红柿炒鸡蛋小份	热菜	菜品	热菜	
西红柿炒鸡蛋小份菜	热菜	菜品	热菜	
西红柿炒鸡蛋小碗菜	热菜	菜品	热菜	
西红柿炒鸡蛋拌面	拌面	主食	面	拌面
西红柿炒鸡蛋拌饭	拌饭	主食	饭	拌饭
西红柿炒鸡蛋木桶饭	木桶饭	主食	饭	木桶饭
西红柿炒鸡蛋来一碗	热菜	菜品	热菜	
西红柿炒鸡蛋炒菜	热菜	菜品	热菜	
西红柿炒鸡蛋煲仔	煲仔饭	主食	饭	煲仔饭
西红柿炒鸡蛋盖交面	盖浇面	主食	面	盖浇面
西红柿炒鸡蛋盖浇饭	盖浇饭	主食	饭	盖浇饭
西红柿炒鸡蛋盖饭	盖浇饭	其他	饭	盖浇饭
西红柿炒鸡蛋饭	盖浇饭	主食	饭	盖浇饭
西红柿炖牛肉	热菜	菜品	热菜	
西红柿炖牛肉汤	汤羹	菜品	汤羹	
西红柿炖牛腩	热菜	菜品	热菜	
西红柿炝锅面	盖浇面	主食	面	盖浇面
西红柿烩面	其他面	主食	面	其他面
西红柿热汤面	汤面	主食	面	汤面
西红柿热面汤	汤面	主食	面	汤面
西红柿煎蛋汤	汤羹	菜品	汤羹	
西红柿爱上笨鸡蛋焖汁饭	盖浇饭	主食	饭	盖浇饭
西红柿牛肉汤	汤羹	菜品	汤羹	
西红柿牛肉面	盖浇面	主食	面	盖浇面
西红柿牛腩汤	热菜	菜品	热菜	
西红柿疙瘩汤	汤羹	菜品	汤羹	
西红柿瘦肉粥	粥	主食	粥	
西红柿盖浇面	盖浇面	主食	面	盖浇面
西红柿盖浇饭	盖浇饭	主食	饭	盖浇饭
西红柿盖饭	盖浇饭	主食	饭	盖浇饭
西红柿笋土豆汤	汤羹	菜品	汤羹	
西红柿素炒小白菜	热菜	菜品	热菜	
西红柿紫菜汤	汤羹	菜品	汤羹	
西红柿紫菜蛋汤	汤羹	菜品	汤羹	
西红柿紫菜蛋花汤	汤羹	菜品	汤羹	
西红柿紫菜鸡蛋汤	汤羹	菜品	汤羹	
西红柿老黄瓜汤	汤羹	菜品	汤羹	
西红柿肉圆汤	汤羹	菜品	汤羹	
西红柿肉圆粉丝汤	其他粉	主食	粉	其他粉
西红柿茄丁面	盖浇面	主食	面	盖浇面
西红柿虾皮疙瘩汤	汤羹	菜品	汤羹	
西红柿蛋汤	热菜	菜品	热菜	
西红柿蛋汤面	汤面	主食	面	汤面
西红柿蛋炒面	炒面	主食	面	炒面
西红柿蛋炒饭	炒饭	主食	饭	炒饭
西红柿蛋盖饭	盖浇饭	主食	饭	盖浇饭
西红柿蛋花汤	汤羹	菜品	汤羹	
西红柿蛋花汤速溶汤	汤羹	菜品	汤羹	
西红柿蛋花珍珠汤	汤羹	菜品	汤羹	
西红柿蛋花疙瘩汤	汤羹	菜品	汤羹	
西红柿蛋面	汤面	主食	面	汤面
西红柿蛋饭	盖浇饭	主食	饭	盖浇饭
西红柿蛋香炒刀削面	炒面	主食	面	炒面
西红柿青菜疙瘩汤	汤羹	菜品	汤羹	
西红柿青菜瘦肉粥	粥	主食	粥	
西红柿青菜鸡蛋面	汤面	主食	面	汤面
西红柿面汤	汤面	主食	面	汤面
西红柿面疙瘩汤	汤羹	菜品	汤羹	
西红柿韭菜疙瘩汤	汤羹	菜品	汤羹	
西红柿鲁蛋面	盖浇面	主食	面	盖浇面
西红柿鸡蛋凉面	凉面	主食	面	凉面
西红柿鸡蛋刀削汤面	其他面	主食	面	其他面
西红柿鸡蛋刀削面	拉面	主食	面	拉面
西红柿鸡蛋削面	其他面	主食	面	其他面
西红柿鸡蛋卤打卤面	盖浇面	主食	面	盖浇面
西红柿鸡蛋卤荞面钢丝面	汤面	主食	面	汤面
西红柿鸡蛋卤面	盖浇面	主食	面	盖浇面
西红柿鸡蛋小份菜	热菜	菜品	热菜	
西红柿鸡蛋小炒	热菜	菜品	热菜	
西红柿鸡蛋小炒十米饭	其他菜品	其他	其他菜品	
西红柿鸡蛋小面	汤面	主食	面	汤面
西红柿鸡蛋干拌面	拌面	主食	面	拌面
西红柿鸡蛋手擀面	汤面	主食	面	汤面
西红柿鸡蛋手擀面汤	手擀面	主食	面	手擀面
西红柿鸡蛋打卤面	盖浇面	主食	面	盖浇面
西红柿鸡蛋扯面	盖浇面	主食	面	盖浇面
西红柿鸡蛋拉面	拉面	主食	面	拉面
西红柿鸡蛋拌刀削面	其他面	主食	面	其他面
西红柿鸡蛋拌汤	汤羹	菜品	汤羹	
西红柿鸡蛋拌面	盖浇面	主食	面	盖浇面
西红柿鸡蛋挂面	盖浇面	主食	面	盖浇面
西红柿鸡蛋挂面汤	汤面	主食	面	汤面
西红柿鸡蛋捞饸饹面	其他面	主食	面	其他面
西红柿鸡蛋木桶饭	木桶饭	主食	饭	木桶饭
西红柿鸡蛋榨面	米线	主食	粉	米线
西红柿鸡蛋汤	汤面	菜品	面	汤面
西红柿鸡蛋汤面	盖浇面	主食	面	盖浇面
西红柿鸡蛋泡饭	泡饭	主食	饭	泡饭
西红柿鸡蛋炒	热菜	菜品	热菜	
西红柿鸡蛋炒刀削	其他面	主食	面	其他面
西红柿鸡蛋炒刀削面	炒面	主食	面	炒面
西红柿鸡蛋炒拉条	炒面	主食	面	炒面
西红柿鸡蛋炒揪片	炒面	主食	面	炒面
西红柿鸡蛋炒米线	米线	主食	粉	米线
西红柿鸡蛋炒菜	热菜	菜品	热菜	
西红柿鸡蛋炒菜花	热菜	菜品	热菜	
西红柿鸡蛋炒面	炒面	主食	面	炒面
西红柿鸡蛋炒饭	炒饭	主食	饭	炒饭
西红柿鸡蛋炒饼	其他主食	主食	其他主食	
西红柿鸡蛋炒馒头	炒面	主食	面	炒面
西红柿鸡蛋烩裤带面	盖浇面	主食	面	盖浇面
西红柿鸡蛋热汤面	汤面	主食	面	汤面
西红柿鸡蛋片汤	汤羹	菜品	汤羹	
西红柿鸡蛋疙瘩汤	汤羹	菜品	汤羹	
西红柿鸡蛋盖浇面	盖浇面	主食	面	盖浇面
西红柿鸡蛋盖浇饭	盖浇饭	其他	饭	盖浇饭
西红柿鸡蛋盖面	盖浇面	主食	面	盖浇面
西红柿鸡蛋盖饭	盖浇饭	其他	饭	盖浇饭
西红柿鸡蛋米面	汤面	主食	面	汤面
西红柿鸡蛋臊子面	汤面	主食	面	汤面
西红柿鸡蛋菜	热菜	菜品	热菜	
西红柿鸡蛋菠菜面	盖浇面	主食	面	盖浇面
西红柿鸡蛋酱拌面	拌面	主食	面	拌面
西红柿鸡蛋锅巴饭	盖浇饭	主食	饭	盖浇饭
西红柿鸡蛋面	盖浇面	菜品	面	盖浇面
西红柿鸡蛋面汤	汤面	主食	面	汤面
西红柿鸡蛋面汤面	汤面	主食	面	汤面
西红柿鸡蛋饭	盖浇饭	主食	饭	盖浇饭
西红柿鸡蛋麦虾面	汤面	主食	面	汤面
西红柿鸡蛋麦面	盖浇面	主食	面	盖浇面
西胡芦炒蛋	热菜	菜品	热菜	
西胪莲藕汤	汤羹	菜品	汤羹	
西芹山药炒木耳	热菜	菜品	热菜	
西芹木耳炒山药	热菜	菜品	热菜	
西芹木耳炒荷兰豆	热菜	菜品	热菜	
西芹炒六年百合	热菜	菜品	热菜	
西芹炒木耳	热菜	菜品	热菜	
西芹炒杏鲍菇	热菜	菜品	热菜	
西芹炒桃仁	热菜	菜品	热菜	
西芹炒瘦肉	热菜	菜品	热菜	
西芹炒百合	热菜	菜品	热菜	
西芹炒肉丝	热菜	菜品	热菜	
西芹炒茄子	热菜	菜品	热菜	
西芹炒虾仁	热菜	菜品	热菜	
西芹炒豆干	热菜	菜品	热菜	
西芹炒青椒半份	热菜	菜品	热菜	
西芹炒香干	热菜	菜品	热菜	
西芹牛肉粥	粥	主食	粥	
西芹百合炒带子	热菜	菜品	热菜	
西芹百合炒腰果	热菜	菜品	热菜	
西芹百合炒花枝片	热菜	菜品	热菜	
西芹百合炒虾仁	热菜	菜品	热菜	
西芹百合炒虾脯	热菜	菜品	热菜	
西芹腰果炒虾球	热菜	菜品	热菜	
西葫炒肉片	热菜	菜品	热菜	
西葫芦炒牛肉	热菜	菜品	热菜	
西葫芦炒肉	热菜	菜品	热菜	
西葫芦炒肉片	热菜	菜品	热菜	
西葫芦炒肉盖浇饭	盖浇饭	主食	饭	盖浇饭
西葫芦炒肉盖饭	盖浇饭	主食	饭	盖浇饭
西葫芦炒虾皮	热菜	菜品	热菜	
西葫芦炒蛋	热菜	菜品	热菜	
西葫芦炒西红柿	热菜	菜品	热菜	
西葫芦炒鸡蛋	热菜	菜品	热菜	
西葫芦炒鸡蛋盖饭	盖浇饭	主食	饭	盖浇饭
西葫芦牛肉拌面	拌面	主食	面	拌面
西葫芦牛肉炒菜	热菜	菜品	热菜	
西葫芦牛肉盖浇面	盖浇面	主食	面	盖浇面
西葫芦牛肉盖浇饭	盖浇饭	主食	饭	盖浇饭
西葫芦牛肉盖面	盖浇面	主食	面	盖浇面
西葫芦鸡蛋盖饭	盖浇饭	主食	饭	盖浇饭
西蓝花炒木耳	热菜	菜品	热菜	
西虹柿炒蛋	热菜	菜品	热菜	
西虹柿炒鸡蛋	热菜	菜品	热菜	
西贝大拌菜	凉菜	菜品	凉菜	
要五常大米饭	白米饭	主食	饭	白米饭
角瓜炒瘦肉片	热菜	菜品	热菜	
角瓜炒鸡蛋	热菜	菜品	热菜	
解暑绿豆粥	粥	主食	粥	
解腻拌花菜	凉菜	菜品	凉菜	
许昌豆腐炖白菜	热菜	菜品	热菜	
请帮我多加生菜	浇头	其他	浇头	
调皮娃娃菜	蔬菜类	菜品	配菜	蔬菜类
谷养元八宝粥	粥	主食	粥	
谷味八宝粥	粥	主食	粥	
谷物八宝粥	粥	主食	粥	
谷色谷香福气粥	粥	主食	粥	
谷记八宝粥	粥	主食	粥	
谷连天八宝粥	粥	主食	粥	
谷香八宝粥	粥	主食	粥	
豆尖豆腐汤	汤羹	菜品	汤羹	
豆干丝炒鲜笋	热菜	菜品	热菜	
豆干炒三丁	热菜	菜品	热菜	
豆干炒大蒜叶	热菜	菜品	热菜	
豆干炒芹菜	热菜	菜品	热菜	
豆干炒豆芽	热菜	菜品	热菜	
豆干炒韭菜	热菜	菜品	热菜	
豆果果黑米粥	粥	主食	粥	
豆棍小碗菜	汤面	主食	面	汤面
豆汁豆苗汤	汤羹	菜品	汤羹	
豆泡烧花菜	热菜	菜品	热菜	
豆泡白菜炖粉条	热菜	菜品	热菜	
豆泡绿豆面丸子汤	汤羹	菜品	汤羹	
豆浆山药美龄粥	粥	主食	粥	
豆浆麦片汤	其他菜品	其他	其他菜品	
豆皮儿卷青菜	蔬菜类	烧烤	蔬菜类	
豆皮包金针菇韭菜	蔬菜类	烧烤	蔬菜类	
豆皮包韭菜	蔬菜类	烧烤	蔬菜类	
豆皮卷生菜	蔬菜类	烧烤	蔬菜类	
豆皮卷金针菇香菜	蔬菜类	烧烤	蔬菜类	
豆皮卷韭菜	蔬菜类	烧烤	蔬菜类	
豆皮卷韭菜菜	蔬菜类	烧烤	蔬菜类	
豆皮卷香菜	蔬菜类	烧烤	配菜	蔬菜类
豆皮小白菜	热菜	菜品	热菜	
豆皮桐花菜	蔬菜类	烧烤	蔬菜类	
豆皮炒青菜	热菜	菜品	热菜	
豆皮炒鸡蛋	热菜	菜品	热菜	
豆皮炖芹菜	热菜	菜品	热菜	
豆皮茼蒿菜	热菜	菜品	热菜	
豆皮鸡蛋汤	汤羹	菜品	汤羹	
豆腐丝炒韭菜	热菜	菜品	热菜	
豆腐丸子小白菜	热菜	菜品	热菜	
豆腐丸子汤	汤羹	菜品	汤羹	
豆腐卷烧芹菜	热菜	菜品	热菜	
豆腐卷生菜	蔬菜类	烧烤	蔬菜类	
豆腐叶炒韭菜	热菜	菜品	热菜	
豆腐土豆小白菜	热菜	菜品	热菜	
豆腐外婆菜	热菜	菜品	热菜	
豆腐小白菜	热菜	菜品	热菜	
豆腐干小炒	热菜	菜品	热菜	
豆腐干炒肉	热菜	菜品	热菜	
豆腐干炒肉丝	热菜	菜品	热菜	
豆腐干炒芹菜	热菜	菜品	热菜	
豆腐干炒西芹	热菜	菜品	热菜	
豆腐干炒酸菜	热菜	菜品	热菜	
豆腐干炒鸡蛋	热菜	菜品	热菜	
豆腐木耳专利拌面	拌面	主食	面	拌面
豆腐杂锦汤	汤羹	菜品	汤羹	
豆腐泡炒大白菜	热菜	菜品	热菜	
豆腐泡炒干豆腐	热菜	菜品	热菜	
豆腐泡炒白菜	热菜	菜品	热菜	
豆腐泡炒肉	热菜	菜品	热菜	
豆腐泡炒韭菜	热菜	菜品	热菜	
豆腐泡炒黑木耳	热菜	菜品	热菜	
豆腐泡烧油菜盖饭	盖浇饭	主食	饭	盖浇饭
豆腐泡芹菜	热菜	菜品	热菜	
豆腐泡韭菜	热菜	菜品	热菜	
豆腐炖面筋	热菜	菜品	热菜	
豆腐烧白菜	热菜	菜品	热菜	
豆腐百叶汤	汤羹	菜品	汤羹	
豆腐皮包韭菜	蔬菜类	烧烤	蔬菜类	
豆腐皮包香菜	蔬菜类	烧烤	蔬菜类	
豆腐皮卷生菜	蔬菜类	烧烤	蔬菜类	
豆腐皮卷菜	蔬菜类	烧烤	蔬菜类	
豆腐皮卷韭菜	蔬菜类	烧烤	蔬菜类	
豆腐皮卷香菜	蔬菜类	烧烤	蔬菜类	
豆腐皮小青菜	热菜	菜品	热菜	
豆腐皮拌娃娃菜	凉菜	菜品	凉菜	
豆腐皮杭白菜	热菜	菜品	热菜	
豆腐皮炒卷芯菜	热菜	菜品	热菜	
豆腐皮炒毛毛菜	热菜	菜品	热菜	
豆腐皮炒肉	热菜	菜品	热菜	
豆腐皮炒肉丝	热菜	菜品	热菜	
豆腐皮炒青菜	热菜	菜品	热菜	
豆腐皮芹菜	凉菜	菜品	凉菜	
豆腐皮蛋汤	汤羹	菜品	汤羹	
豆腐皮青菜	热菜	菜品	热菜	
豆腐皮韭菜	蔬菜类	烧烤	蔬菜类	
豆腐皮鲞粥	粥	主食	粥	
豆腐皮鸡蛋面	汤面	主食	面	汤面
豆腐粉丝鸡蛋汤	其他粉	主食	粉	其他粉
豆腐紫菜汤	汤羹	菜品	汤羹	
豆腐羹蛋汤	汤羹	菜品	汤羹	
豆腐肉丝汤	汤羹	菜品	汤羹	
豆腐肉沫汤	汤羹	菜品	汤羹	
豆腐脑无香菜	汤羹	菜品	汤羹	
豆腐脑紫菜鸡蛋汤	汤羹	菜品	汤羹	
豆腐芹菜炒肉	热菜	菜品	热菜	
豆腐菜叶汤	汤羹	菜品	汤羹	
豆腐菠菜汤	汤羹	菜品	汤羹	
豆腐萝卜养生汤	热菜	菜品	热菜	
豆腐青菜汤	汤羹	菜品	汤羹	
豆腐青菜蛋汤	汤羹	菜品	汤羹	
豆腐饸饹面	汤面	主食	面	汤面
豆腐鱼头汤	汤羹	菜品	汤羹	
豆腐鱼海虾粥	粥	主食	粥	
豆腐鱼腩饭	盖浇饭	主食	饭	盖浇饭
豆腐鲫鱼汤	汤羹	菜品	汤羹	
豆腐鸡蛋汤	汤羹	菜品	汤羹	
豆花肉碎汤	汤羹	菜品	汤羹	
豆芽五香面	拌面	主食	面	拌面
豆芽元子汤	汤羹	菜品	汤羹	
豆芽冷拌面	拌面	主食	面	拌面
豆芽头炒粉条	热菜	菜品	热菜	
豆芽炒三丝	热菜	菜品	热菜	
豆芽炒包菜	热菜	菜品	热菜	
豆芽炒合菜	热菜	菜品	热菜	
豆芽炒干豆付	热菜	菜品	热菜	
豆芽炒干豆付韭菜	热菜	菜品	热菜	
豆芽炒干豆腐	热菜	菜品	热菜	
豆芽炒海带	热菜	菜品	热菜	
豆芽炒海带丝	热菜	菜品	热菜	
豆芽炒海蜇皮	热菜	菜品	热菜	
豆芽炒牛肉	热菜	菜品	热菜	
豆芽炒牛肉丝	热菜	菜品	热菜	
豆芽炒粉丝	热菜	菜品	热菜	
豆芽炒粉小	热菜	菜品	热菜	
豆芽炒粉小食量	米线	主食	粉	米线
豆芽炒粉条	热菜	菜品	热菜	
豆芽炒肉丝	热菜	菜品	热菜	
豆芽炒芹菜	热菜	菜品	热菜	
豆芽炒茭白	热菜	菜品	热菜	
豆芽炒蒜苗	热菜	菜品	热菜	
豆芽炒豆腐皮	热菜	菜品	热菜	
豆芽炒青椒	其他主食	主食	其他主食	
豆芽炒韭菜	热菜	菜品	热菜	
豆芽炒韭菜香干	热菜	菜品	热菜	
豆芽炒鸡蛋	热菜	菜品	热菜	
豆芽爆炒韭菜	热菜	菜品	热菜	
豆芽白菜炒粉条	热菜	菜品	热菜	
豆芽肉丝炒粉丝	热菜	菜品	热菜	
豆芽肉丝炒饼	其他主食	主食	其他主食	
豆芽菜小炒	热菜	菜品	热菜	
豆芽菜炒粉	热菜	菜品	热菜	
豆芽菜炒粉头	热菜	菜品	热菜	
豆芽菜炒肉丝	热菜	菜品	热菜	
豆芽菜炒韭菜	热菜	菜品	热菜	
豆芽蛋炒米粉	米线	主食	粉	米线
豆芽豆皮油菜	其他菜品	其他	其他菜品	
豆芽豆皮炒韭菜	热菜	菜品	热菜	
豆芽韭菜炒粉	热菜	菜品	热菜	
豆芽韭菜炒肉丝	热菜	菜品	热菜	
豆芽鸡蛋炒粉	米线	主食	粉	米线
豆芽鸡蛋炒饼	其他主食	主食	其他主食	
豆苗炒土豆丝	热菜	菜品	热菜	
豆角丝汆面	汤面	主食	面	汤面
豆角丝炒肉丝	热菜	菜品	热菜	
豆角土豆粘玉米焖手擀面	手擀面	主食	面	手擀面
豆角外婆菜炒鸡蛋	热菜	菜品	热菜	
豆角橄榄菜	热菜	菜品	热菜	
豆角炒肉丝	热菜	菜品	热菜	
豆角炒肉十米饭十软饮	其他菜品	其他	其他菜品	
豆角炒肉木桶饭	木桶饭	主食	饭	木桶饭
豆角炒肉煲仔	煲仔饭	主食	饭	煲仔饭
豆角炒茄子	热菜	菜品	热菜	
豆角炒茄条	热菜	菜品	热菜	
豆角炒鸡蛋	热菜	菜品	热菜	
豆角炒鸡蛋饭	盖浇饭	主食	饭	盖浇饭
豆角炖南瓜	热菜	菜品	热菜	
豆角炖土豆	热菜	菜品	热菜	
豆角烧茄子盖浇饭	盖浇饭	主食	饭	盖浇饭
豆角肉打卤面	盖浇面	主食	面	盖浇面
豆角肉末饭	盖浇饭	主食	饭	盖浇饭
豆角肉沫打卤面	盖浇面	主食	面	盖浇面
豆角肉片饭	盖浇饭	主食	饭	盖浇饭
豆角茄子双拼饭	盖浇饭	主食	饭	盖浇饭
豆角茄子小碗菜	热菜	菜品	热菜	
豆角茄子护心肉三拼饭	盖浇饭	主食	饭	盖浇饭
豆角茄子木桶饭	木桶饭	主食	饭	木桶饭
豆角茄子炒菜	热菜	菜品	热菜	
豆角茄子盖饭	盖浇饭	主食	饭	盖浇饭
豆角茄子饭	盖浇饭	主食	饭	盖浇饭
豆角鸡肉双拼饭	盖浇饭	主食	饭	盖浇饭
豆酱秋葵炒山药	热菜	菜品	热菜	
豆面丸子汤	粥	菜品	粥	
豆面面结汤	汤面	主食	面	汤面
豇豆小米稀饭	粥	主食	粥	
豇豆炒土豆中	热菜	菜品	热菜	
豇豆炒茄子	热菜	菜品	热菜	
豇豆角炒肉半分	热菜	菜品	热菜	
豉汁凉瓜炒牛肉	热菜	菜品	热菜	
豉汁炒凉瓜	热菜	菜品	热菜	
豉汁罗马生菜	热菜	菜品	热菜	
豉汁西生菜	热菜	菜品	热菜	
豉油油麦菜	热菜	菜品	热菜	
豉油皇直立生菜	热菜	菜品	热菜	
豉油罗马生菜	热菜	菜品	热菜	
豉油蒜香生菜	热菜	菜品	热菜	
豉油高山生菜	热菜	菜品	热菜	
豉蒜凉瓜炒牛肉	热菜	菜品	热菜	
豉香扁豆炒肉丝	热菜	菜品	热菜	
豌豆尖豆腐汤	汤羹	菜品	汤羹	
豌豆炒肉丝	热菜	菜品	热菜	
豌豆炒萝卜干	热菜	菜品	热菜	
豌豆米炒腌菜	热菜	菜品	热菜	
豌豆米炒鸡蛋	热菜	菜品	热菜	
豌豆青菜面	汤面	主食	面	汤面
象鼻十虾粥	粥	主食	粥	
豪华西红柿鸡蛋面	汤面	主食	面	汤面
贝壳豆腐汤	汤羹	菜品	汤羹	
贝柱鲜虾粥	粥	主食	粥	
贡丸粗粮面	汤面	主食	面	汤面
贡丸香菇莴笋汤	汤羹	菜品	汤羹	
贡品白米饭	白米饭	主食	饭	白米饭
贡園粉丝汤	其他粉	主食	粉	其他粉
财神八宝粥	粥	主食	粥	
财鱼片豆腐汤	汤羹	菜品	汤羹	
财鱼豆腐汤	汤羹	菜品	汤羹	
贵安黄冰糖鲜炖梨汤	汤羹	菜品	汤羹	
贵州鸡蛋汤饭	泡饭	主食	饭	泡饭
贺兰山鸡肉蘑菇面	汤面	主食	面	汤面
赤小豆薏仁汤	糖水/炖品	甜点	糖水/炖品	
赤根小菠菜	蔬菜类	火锅/串串/麻辣烫/色拉自选	配菜	蔬菜类
赤红豆薏米粥	粥	主食	粥	
赤豆元宵粥	粥	主食	粥	
赵家大烩菜	热菜	菜品	热菜	
超值木须肉盖饭	盖浇饭	主食	饭	盖浇饭
超值特价西红柿鸡蛋面	汤面	主食	面	汤面
超省推荐黑米粥	粥	主食	粥	
超级开胃下饭的老厨白菜	热菜	菜品	热菜	
超级香米饭	白米饭	主食	饭	白米饭
越光大米饭	白米饭	主食	饭	白米饭
越式咖喱蔬菜	热菜	菜品	热菜	
足料多多多皮蛋瘦肉粥	粥	主食	粥	
足料多多皮蛋瘦肉粥	粥	主食	粥	
足料大碗皮蛋瘦肉粥	粥	主食	粥	
路友大拌菜	凉菜	菜品	凉菜	
跷脚娃娃菜	蔬菜类	火锅/串串/麻辣烫/色拉自选	配菜	蔬菜类
软炒菠萝鸡片	热菜	菜品	热菜	
软烧茄子饭	盖浇饭	主食	饭	盖浇饭
软糯小米红枣粥	粥	主食	粥	
软糯燕麦南瓜粥	粥	主食	粥	
软糯紫米粥	粥	主食	粥	
软糯香甜八宝粥	粥	主食	粥	
软香大米饭	白米饭	主食	饭	白米饭
辛氏小土豆炖牛肉	热菜	菜品	热菜	
辣炒绿豆芽	热菜	菜品	热菜	
辣白菜炖豆腐	热菜	菜品	热菜	
辽参山药鱼片粥	粥	主食	粥	
辽西干豆腐炒尖椒	热菜	菜品	热菜	
过水大碴粥	粥	主食	粥	
这是一碗香喷喷的大米饭	白米饭	主食	饭	白米饭
连白炒粉丝	热菜	菜品	热菜	
选择紫米面	其他主食	主食	其他主食	
选择绿豆面	汤面	主食	面	汤面
逍遥素食胡辣汤	汤羹	菜品	汤羹	
速溶番茄汤	汤羹	菜品	汤羹	
避风塘艇仔粥	粥	主食	粥	
那么香米饭	白米饭	主食	饭	白米饭
邱记一品粥	粥	主食	粥	
郑记状元粥	粥	主食	粥	
郭林大拌菜	凉菜	菜品	凉菜	
配菜娃娃菜	浇头	其他	浇头	
酥肉炖白菜粉条	热菜	菜品	热菜	
酥肉炖豆腐套餐	其他菜品	其他	其他菜品	
酥肉烩白菜	热菜	菜品	热菜	
酱干豆腐炒鸡蛋	热菜	菜品	热菜	
酱扒茄子十米饭	其他菜品	其他	其他菜品	
酱扒茄子子盖浇饭	盖浇饭	主食	饭	盖浇饭
酱拌手撕菜	凉菜	菜品	饭	其他饭
酱汁小炒茄子	热菜	菜品	热菜	
酱油土豆条炒肉丝	热菜	菜品	热菜	
酱油炒土豆丝	热菜	菜品	热菜	
酱油炒豆腐	热菜	菜品	热菜	
酱炒土豆片	热菜	菜品	热菜	
酱炒小葱鸡蛋	热菜	菜品	热菜	
酱炒杏鲍菇	热菜	菜品	热菜	
酱炒绿豆芽	热菜	菜品	热菜	
酱炒茄子小份	热菜	菜品	热菜	
酱炒西葫芦	热菜	菜品	热菜	
酱炒豆腐皮	热菜	菜品	热菜	
酱炒鸡蛋小	热菜	菜品	热菜	
酱炒鸡蛋小份	热菜	菜品	热菜	
酱炒鸡蛋小毛葱	热菜	菜品	热菜	
酱炒鸡蛋尖椒	热菜	菜品	热菜	
酱炖卤水豆腐	热菜	菜品	热菜	
酱炖嘎牙鱼	热菜	菜品	热菜	
酱炖大豆腐小碗	热菜	菜品	热菜	
酱炖小江鱼	热菜	菜品	热菜	
酱炖小鲫鱼	热菜	菜品	热菜	
酱炖碎豆腐	热菜	菜品	热菜	
酱炖豆腐土豆条	热菜	菜品	热菜	
酱炖豆腐盖浇饭	盖浇饭	主食	饭	盖浇饭
酱爆包心菜	热菜	菜品	热菜	
酱爆卷心菜	热菜	菜品	热菜	
酱爆圆白菜	热菜	菜品	热菜	
酱爆圆白菜炒菜	热菜	菜品	热菜	
酱爆洋白菜	热菜	菜品	热菜	
酱爆洋白菜小炒加米饭	盖浇饭	主食	饭	盖浇饭
酱爆洋白菜炒菜	热菜	菜品	热菜	
酱爆茄子炒菜	热菜	菜品	热菜	
酱茄子盖浇饭	盖浇饭	主食	饭	盖浇饭
酱茄子盖饭	盖浇饭	主食	饭	盖浇饭
酱莲菜炒肉	热菜	菜品	热菜	
酱萝卜老鸭汤	汤羹	菜品	汤羹	
酱酱炖茄子	热菜	菜品	热菜	
酱香全素炒米粉	米线	主食	粉	米线
酱香八宝菜	凉菜	菜品	凉菜	
酱香外婆菜	凉菜	菜品	凉菜	
酱香素炒米粉	米线	主食	粉	米线
酱香茄子盖饭	盖浇饭	主食	饭	盖浇饭
酱香茄子米饭	其他饭	主食	饭	其他饭
酱香茄子饭	盖浇饭	主食	饭	盖浇饭
酱鸡蛋炒黑木耳	热菜	菜品	热菜	
酱黄瓜萝卜小菜	凉菜	菜品	凉菜	
酸包菜炒土豆片	热菜	菜品	热菜	
酸包菜炒水晶粉	热菜	菜品	热菜	
酸包菜炒粉皮	热菜	菜品	热菜	
酸包菜粉丝炒肉丝	热菜	菜品	热菜	
酸梅紫米粥	粥	主食	粥	
酸汤小揪面	汤面	主食	面	汤面
酸汤香菇面	汤面	主食	面	汤面
酸浆手擀面	手擀面	主食	面	手擀面
酸溜大白菜	热菜	菜品	热菜	
酸爽包心菜	热菜	菜品	热菜	
酸甜不辣烤冷面	其他面	主食	面	其他面
酸甜口荞麦冷面	凉面	主食	面	凉面
酸甜大拌菜	凉菜	菜品	凉菜	
酸甜娃娃菜	热菜	菜品	热菜	
酸甜紫包菜	凉菜	菜品	凉菜	
酸甜荞麦冷面	凉面	主食	面	凉面
酸甜菠萝粥	粥	主食	粥	
酸白菜拌面	拌面	主食	面	拌面
酸粉炒土豆丝	热菜	菜品	热菜	
酸菜三丝面	汤面	主食	面	汤面
酸菜丽江炒魔芋	热菜	菜品	热菜	
酸菜土豆丝汤	汤羹	菜品	汤羹	
酸菜土豆丝炒粉条	热菜	菜品	热菜	
酸菜土豆丝盖饭	盖浇饭	主食	饭	盖浇饭
酸菜土豆条汤	汤羹	菜品	汤羹	
酸菜土豆粉丝汤	其他粉	主食	粉	其他粉
酸菜小笋小碗菜	热菜	菜品	热菜	
酸菜洋芋汤	汤羹	菜品	汤羹	
酸菜炒刀削	其他面	主食	面	其他面
酸菜炒土豆丝	热菜	菜品	热菜	
酸菜炒土豆丝小份	热菜	菜品	热菜	
酸菜炒春笋	热菜	菜品	热菜	
酸菜炒甜笋	热菜	菜品	热菜	
酸菜炒甜豆	热菜	菜品	热菜	
酸菜炒瘦肉	热菜	菜品	热菜	
酸菜炒笨鸡蛋	热菜	菜品	热菜	
酸菜炒粉丝	热菜	菜品	热菜	
酸菜炒粉条	米线	菜品	粉	米线
酸菜炒肉丝	热菜	菜品	热菜	
酸菜炒肉丝粉条	热菜	菜品	热菜	
酸菜炒薯粉	热菜	菜品	热菜	
酸菜炒蘑菇	热菜	菜品	热菜	
酸菜炒豆腐	热菜	菜品	热菜	
酸菜炒豆芽	热菜	菜品	热菜	
酸菜炒魔芋	热菜	菜品	热菜	
酸菜炒魔芋丝	热菜	菜品	热菜	
酸菜炒鸡蛋	热菜	菜品	热菜	
酸菜炖冻豆腐	热菜	菜品	热菜	
酸菜炖土豆丝	热菜	菜品	热菜	
酸菜炖拆骨肉	热菜	菜品	热菜	
酸菜炖白丸子	热菜	菜品	热菜	
酸菜炖粉条	热菜	菜品	热菜	
酸菜炖粉条冻豆腐	热菜	菜品	热菜	
酸菜炖老豆腐	热菜	菜品	热菜	
酸菜炖豆腐	热菜	菜品	热菜	
酸菜炖豆腐一碗	热菜	菜品	热菜	
酸菜炖豆腐小份	热菜	菜品	热菜	
酸菜疙瘩汤	汤羹	菜品	汤羹	
酸菜笋片炒蘑菇	热菜	菜品	热菜	
酸菜米豆汤	汤羹	菜品	汤羹	
酸菜粉丝汤	其他粉	主食	粉	其他粉
酸菜粉小份加米饭	其他菜品	其他	其他菜品	
酸菜粉小份菜	热菜	菜品	热菜	
酸菜粉炒肉丝	热菜	菜品	热菜	
酸菜素炒米粉	米线	主食	粉	米线
酸菜红豆汤	汤羹	菜品	汤羹	
酸菜脆笋鸡肉粥粥	粥	主食	粥	
酸菜豆米汤饭	泡饭	主食	饭	泡饭
酸菜豆腐汤	汤羹	菜品	汤羹	
酸菜香干炒肉	热菜	菜品	热菜	
酸菜骨头豆腐汤	热菜	菜品	热菜	
酸菜黄鱼面	汤面	主食	面	汤面
酸菜黑鱼十米饭十配菜	其他菜品	其他	其他菜品	
酸萝卜丝炒肉	热菜	菜品	热菜	
酸萝卜丝炒藕粉	热菜	菜品	热菜	
酸萝卜炒粉	米线	菜品	粉	米线
酸萝卜炒粉条	热菜	菜品	热菜	
酸萝卜炒肉丝	热菜	菜品	热菜	
酸萝卜炒藕尖	热菜	菜品	热菜	
酸萝卜炖老鸭	热菜	菜品	热菜	
酸萝卜老鸭汤	汤羹	菜品	汤羹	
酸蓉空心菜	热菜	菜品	热菜	
酸豆角炒牛蒡一斤装	热菜	菜品	热菜	
酸豆角炒米饭	炒饭	主食	饭	炒饭
酸豆角炒肉末	热菜	菜品	热菜	
酸豆角炒蛋	热菜	菜品	热菜	
酸豆角炒豆腐干	热菜	菜品	热菜	
酸豆角鸡蛋炒饭	炒饭	主食	饭	炒饭
酸辣包心菜	热菜	菜品	热菜	
酸辣土豆丝小份菜	热菜	菜品	热菜	
酸辣土豆丝小碗菜	热菜	菜品	热菜	
酸辣大白菜	热菜	菜品	热菜	
酸辣大白菜十米饭	盖浇饭	主食	饭	盖浇饭
酸辣娃娃菜	热菜	菜品	热菜	
酸辣小白菜	热菜	菜品	热菜	
酸辣平包菜	热菜	菜品	热菜	
酸辣手撕包菜	热菜	菜品	热菜	
酸辣炒土豆丝	热菜	菜品	热菜	
酸辣炒白菜	热菜	菜品	热菜	
酸辣炒藕片	热菜	菜品	热菜	
酸辣炒豆芽	热菜	菜品	热菜	
酸辣玉米面	汤面	主食	面	汤面
酸辣白菜小份菜	热菜	菜品	热菜	
酸辣白菜小炒	热菜	菜品	热菜	
酸辣空心菜	热菜	菜品	热菜	
酸辣素炒土豆丝	热菜	菜品	热菜	
酸辣腐皮炒木耳	热菜	菜品	热菜	
酸辣裙带菜	凉菜	菜品	凉菜	
酸辣西红柿蛋汤	汤羹	菜品	汤羹	
酸辣豆腐条汤	汤羹	菜品	汤羹	
酸辣豆腐汤	热菜	菜品	热菜	
酸辣豆芽菜	热菜	菜品	热菜	
酸辣鸡蛋汤	汤羹	菜品	汤羹	
酸黄瓜炒肉	热菜	菜品	热菜	
酸黄瓜炒肉丝	热菜	菜品	热菜	
醇香小米粥	粥	主食	粥	
醇香白米饭	白米饭	主食	饭	白米饭
醇香鸡肉粥	粥	主食	粥	
醇香黑米粥	粥	主食	粥	
醋椒扇贝汤	汤羹	菜品	汤羹	
醋椒豆腐汤	汤羹	菜品	汤羹	
醋椒鸡蛋汤	汤羹	菜品	汤羹	
醋溜丸子黑白菜	热菜	菜品	热菜	
醋溜卷心菜	热菜	菜品	热菜	
醋溜土豆丝盖浇饭	盖浇饭	主食	饭	盖浇饭
醋溜土豆丝盖饭	盖浇饭	主食	饭	盖浇饭
醋溜土豆丝饭	盖浇饭	主食	饭	盖浇饭
醋溜土豆片盖浇面	盖浇面	主食	面	盖浇面
醋溜大白菜	热菜	菜品	热菜	
醋溜大白菜盖饭	盖浇饭	主食	饭	盖浇饭
醋溜娃娃菜	热菜	菜品	热菜	
醋溜木耳白菜	热菜	菜品	热菜	
醋溜木须中份菜	热菜	菜品	热菜	
醋溜木须洋白菜	热菜	菜品	热菜	
醋溜木须素菜	热菜	菜品	热菜	
醋溜白菜小炒	热菜	菜品	热菜	
醋溜白菜盖浇饭	盖浇饭	主食	饭	盖浇饭
醋溜白菜盖饭	盖浇饭	主食	饭	盖浇饭
醋溜豆芽菜	热菜	菜品	热菜	
醋炒绿豆芽	热菜	菜品	热菜	
醋炒长豆芽	热菜	菜品	热菜	
醋肉萝卜汤	汤羹	菜品	汤羹	
醪糟银耳汤	糖水/炖品	甜点	糖水/炖品	
里脊拌荞麦面	拌面	主食	面	拌面
重庆素小面	汤面	主食	面	汤面
重庆豆花饭	泡饭	主食	饭	泡饭
野口蘑炒莜面窝	炒面	主食	面	炒面
野山芹炒肉丝	热菜	菜品	热菜	
野山菇炖鸡块	热菜	菜品	热菜	
野山菌炒面筋	热菜	菜品	热菜	
野山菌王汤	汤羹	菜品	汤羹	
野山菌胡辣汤	汤羹	菜品	汤羹	
野山蘑小白菜	热菜	菜品	热菜	
野木耳汤饭	泡饭	主食	饭	泡饭
野木耳炒山药	热菜	菜品	热菜	
野水芹炒香干	热菜	菜品	热菜	
野生木耳炒淮山	热菜	菜品	热菜	
野生海蛎子荠菜汤	汤羹	菜品	汤羹	
野生菌时蔬汤面	汤面	主食	面	汤面
野生菌菇汤	汤羹	菜品	汤羹	
野生蘑菇面	盖浇面	主食	面	盖浇面
野生蛎黄炖小白菜	热菜	菜品	热菜	
野笋干炒毛豆	热菜	菜品	热菜	
野米炒鸡蛋	热菜	菜品	热菜	
野荠菜豆腐汤	汤羹	菜品	汤羹	
野菌川元汤	汤羹	菜品	汤羹	
野菌肉丸汤	汤羹	菜品	汤羹	
野菌肉片汤	汤羹	菜品	汤羹	
野菜虾仁炒鸡蛋	热菜	菜品	热菜	
野葱花炒丝瓜	热菜	菜品	热菜	
野葱花疙瘩汤	汤羹	菜品	汤羹	
金丝南瓜小米粥	粥	主食	粥	
金丝南瓜粥	粥	主食	粥	
金丝南瓜红薯干粥	粥	主食	粥	
金丝小米粥	粥	主食	粥	
金丝枣枸杞粥	粥	主食	粥	
金丝玉米面	汤面	主食	面	汤面
金丝红枣南瓜粥	粥	主食	粥	
金丝红枣枸杞粥	粥	主食	粥	
金兰炒疙瘩	炒面	主食	面	炒面
金奖酸辣白菜	热菜	菜品	热菜	
金枪鱼蔬菜粥	粥	主食	粥	
金汤南瓜粥	粥	主食	粥	
金汤娃娃菜	热菜	菜品	热菜	
金汤干贝波菜	热菜	菜品	热菜	
金汤皮蛋瘦肉粥	粥	主食	粥	
金汤虾滑十米饭	汤羹	菜品	汤羹	
金汤酸菜黑鱼面	汤面	主食	面	汤面
金津老鸭粉丝汤	其他粉	主食	粉	其他粉
金牌五常有机米饭	白米饭	主食	饭	白米饭
金牌八宝粥	粥	主食	粥	
金牌小米粥	粥	主食	粥	
金牌老鸭粉丝汤	其他粉	主食	粉	其他粉
金牌胴骨粥	粥	主食	粥	
金牌艇仔粥	其他菜品	其他	其他菜品	
金牌酸辣白菜	热菜	菜品	热菜	
金玉南瓜粥	粥	主食	粥	
金珍菌菇汤	汤羹	菜品	汤羹	
金瓜叶清炒	热菜	菜品	热菜	
金瓜小米粥	粥	主食	粥	
金瓜枸杞小米粥	粥	主食	粥	
金瓜玉米粥	粥	主食	粥	
金瓜红薯小米粥	粥	主食	粥	
金米南瓜粥	粥	主食	粥	
金苗小米粥	粥	主食	粥	
金蒜油麦菜	热菜	菜品	热菜	
金蛋炒合菜	热菜	菜品	热菜	
金装乌冬面	其他菜品	其他	其他菜品	
金针木耳豆腐汤	汤羹	菜品	汤羹	
金针瘦肉汤	汤羹	菜品	汤羹	
金针肉丝汤	汤羹	菜品	汤羹	
金针茹炒肉	热菜	菜品	热菜	
金针菇丨低卡素菜	蔬菜类	火锅/串串/麻辣烫/色拉自选	配菜	蔬菜类
金针菇小炒	热菜	菜品	热菜	
金针菇山野菜	热菜	菜品	热菜	
金针菇拌菠菜	凉菜	菜品	凉菜	
金针菇杂酱面	其他面	主食	面	其他面
金针菇炒剪豆	热菜	菜品	热菜	
金针菇炒绿豆芽	热菜	菜品	热菜	
金针菇炒肉	热菜	菜品	热菜	
金针菇炒肉丝	热菜	菜品	热菜	
金针菇炒蛋	热菜	菜品	热菜	
金针菇煮蛋汤	汤羹	菜品	汤羹	
金针菇肉丝汤	汤羹	菜品	汤羹	
金针菇蛋汤	汤羹	菜品	汤羹	
金针菇蛋花汤	汤羹	菜品	汤羹	
金针菇鸡蛋肉片汤	汤羹	菜品	汤羹	
金银娃娃菜	热菜	菜品	热菜	
金银蛋上汤菠菜	热菜	菜品	热菜	
金银蛋娃娃菜	热菜	菜品	热菜	
金银蛋瘦肉粥	粥	主食	粥	
金黄浓稠南瓜粥	粥	主食	粥	
金黄玉米粥	粥	主食	粥	
鑫裕园果蔬拌菜	凉菜	菜品	凉菜	
鑫麦良南瓜小米粥	粥	主食	粥	
钱商植物贡菜	凉菜	菜品	凉菜	
钵仔娃娃菜	热菜	菜品	热菜	
钵子生炒扁豆丝	热菜	菜品	热菜	
铁勺大拌菜	凉菜	菜品	凉菜	
铁板包菜炒粉丝	热菜	菜品	热菜	
铁板卷心菜	蔬菜类	菜品	蔬菜类	
铁板卷心菜炒粉丝	热菜	菜品	粉	其他粉
铁板大头菜	热菜	菜品	热菜	
铁板娃娃菜	蔬菜类	菜品	蔬菜类	
铁板手撕包心菜	热菜	菜品	热菜	
铁板手撕包菜	热菜	菜品	热菜	
铁板松花菜	热菜	菜品	热菜	
铁板油麦菜	热菜	菜品	热菜	
铁板空心菜	热菜	菜品	热菜	
铁板粉丝包菜	热菜	菜品	热菜	
铁板粉丝莲花菜	热菜	菜品	热菜	
铁板蔬菜鸡蛋炒饭	炒饭	主食	饭	炒饭
铁棍山药炒木耳	热菜	菜品	热菜	
铁棍山药青菜粥	粥	主食	粥	
铁锅土豆炖茄子	热菜	菜品	热菜	
铁锅捞二米饭	白米饭	主食	饭	白米饭
铁锅炖包头鱼	热菜	菜品	热菜	
铁锅炖水库花鲢子	热菜	菜品	热菜	
铁锅炖豆腐	热菜	菜品	热菜	
铁锅炖豆角	热菜	菜品	热菜	
铁锅生炒土豆丝	热菜	菜品	热菜	
铁锅豆角焖面	焖面	主食	面	焖面
铁锅鳕鱼炖豆腐	热菜	菜品	热菜	
银杏百合汤	糖水/炖品	甜点	糖水/炖品	
银杏百合炒芦笋	热菜	菜品	热菜	
银耳南瓜汤	汤羹	菜品	汤羹	
银耳南瓜粥	粥	主食	粥	
银耳大枣粥	粥	主食	粥	
银耳枸杞汤	糖水/炖品	甜点	糖水/炖品	
银耳枸杞粥	粥	主食	粥	
银耳桃胶汤	其他甜品	甜点	其他甜品	
银耳桃胶粥	粥	主食	粥	
银耳润肺粥	粥	主食	粥	
银耳百合汤	糖水/炖品	甜点	糖水/炖品	
银耳百合莲子汤	糖水/炖品	甜点	糖水/炖品	
银耳红枣枸杞粥	粥	主食	粥	
银耳红枣汤	糖水/炖品	甜点	糖水/炖品	
银耳红枣粥	粥	主食	粥	
银耳红糖大枣粥	粥	主食	粥	
银耳莲子枸杞粥	粥	主食	粥	
银耳莲子汤	糖水/炖品	菜品	糖水/炖品	
银耳莲子炖红枣	糖水/炖品	甜点	糖水/炖品	
银耳莲子炖雪梨	其他甜品	甜点	其他甜品	
银耳莲子粥	粥	主食	粥	
银耳莲子红枣粥	粥	主食	粥	
银耳莲子绿豆粥	粥	主食	粥	
银耳雪梨汤	糖水/炖品	甜点	糖水/炖品	
银耳雪梨粥	粥	主食	粥	
银鱼丝炖蛋	热菜	菜品	热菜	
银鱼炒鸡蛋	热菜	菜品	热菜	
锅仔海米白菜炖豆腐	热菜	菜品	热菜	
锅仔番茄炖牛肉	热菜	菜品	热菜	
锅仔菌茹丸子汤	汤羹	菜品	汤羹	
锅仔西红柿炖牛肉	热菜	菜品	热菜	
锅仔西红柿炖牛腩	热菜	菜品	热菜	
锅仔鱼块炖豆腐	热菜	菜品	热菜	
锅塌虾仁炒菜	热菜	菜品	热菜	
锅子牛肉炖萝卜	热菜	菜品	热菜	
锅气拍蒜炒芥兰苗	热菜	菜品	热菜	
锅贴鸡蛋韭菜	锅贴	主食	锅贴	
锡包娃娃菜	热菜	菜品	热菜	
锡纸娃娃菜	蔬菜类	菜品	蔬菜类	
锡纸孜然菠菜	蔬菜类	烧烤	蔬菜类	
锡纸烤娃娃菜	蔬菜类	烧烤	蔬菜类	
锡纸粉丝娃娃菜	蔬菜类	烧烤	蔬菜类	其他粉
锡纸粗粮面	汤面	主食	面	汤面
锡纸花甲娃娃菜	其他粉	主食	粉	其他粉
锡纸蒜泥花菜	蔬菜类	烧烤	蔬菜类	
锦州干豆腐炒尖椒	热菜	菜品	热菜	
锦州豆腐皮炒牛肉	热菜	菜品	热菜	
镇店之宝八宝粥	粥	主食	粥	
镇店八宝粥	粥	主食	粥	
镇店虾仁粥	粥	主食	粥	
长不大娃娃菜	蔬菜类	火锅/串串/麻辣烫/色拉自选	配菜	蔬菜类
长寿地瓜粥	粥	主食	粥	
长寿菜炒笋丝	热菜	菜品	热菜	
长山药炒木耳	热菜	菜品	热菜	
长治面疙瘩汤	汤羹	菜品	汤羹	
长白山菌汤	汤羹	菜品	汤羹	
长粒香米米饭	白米饭	主食	饭	白米饭
长粒香米饭	白米饭	主食	饭	白米饭
长豆炒土豆条	热菜	菜品	热菜	
长豆炒肉沫	热菜	菜品	热菜	
长豆炒茄子	热菜	菜品	热菜	
长豆炒鸡蛋	热菜	菜品	热菜	
长豆角炒外婆菜煲仔	煲仔饭	主食	饭	煲仔饭
长豆角炒山茄	热菜	菜品	热菜	
长豆角炒肉	热菜	菜品	热菜	
长豆角炒肉丝	热菜	菜品	热菜	
长豆角炒茄子	热菜	菜品	热菜	
长豆角炒鸡丝小份	热菜	菜品	热菜	
闽北鲜炒笋尖	热菜	菜品	热菜	
闽南包菜饭	盖浇饭	主食	饭	盖浇饭
闽南杂菜汤	汤羹	菜品	汤羹	
闽南炒面线	汤面	主食	面	汤面
闽南芥菜饭	拌饭	主食	饭	拌饭
阴米肚片粥	粥	主食	粥	
阿妈瘦肉粥	粥	主食	粥	
阿婆小泡菜	凉菜	菜品	凉菜	
阿婆炒合菜	热菜	菜品	热菜	
阿婆粗粮菜	其他主食	主食	其他主食	
阿婆粥蔬菜粥	粥	主食	粥	
阿泰八宝粥	粥	主食	粥	
阿瓦小青菜	热菜	菜品	热菜	
陇椒炒鸡蛋	热菜	菜品	热菜	
陈傻子白菜豆腐汤	汤羹	菜品	汤羹	
陈皮红豆粥	粥	主食	粥	
陈皮雪梨炖桃胶	其他甜品	甜点	其他甜品	
陈记八宝粥	粥	主食	粥	
陈醋果仁菠菜	凉菜	菜品	凉菜	
降噪绿豆百合粥	粥	主食	粥	
限量鸡蛋汤	汤羹	菜品	汤羹	
陕北小米粥	粥	主食	粥	
陕北炒洋芋擦擦	热菜	菜品	热菜	
陕北炒馍馍	热菜	菜品	热菜	
陕北荞面饸饹面	汤面	主食	面	汤面
陕南浆水面	汤面	主食	面	汤面
陜北特色小米粥	粥	主食	粥	
随州三鲜烩白菜	热菜	菜品	热菜	
随机新蔬菜	热菜	菜品	热菜	
随机样菜玉米面	汤面	主食	面	汤面
随机素拼凉菜	凉菜	菜品	凉菜	
雅香洋白菜鸡蛋炒饼	其他主食	主食	其他主食	
雪梨南瓜银耳粥	粥	主食	粥	
雪梨无花果炖瘦肉汤	浇头	其他	浇头	
雪梨润肺粥	粥	主食	粥	
雪梨炖银耳	其他甜品	甜点	其他甜品	
雪梨百合汤	其他甜品	甜点	其他甜品	
雪梨红枣炖银耳	其他甜品	甜点	其他甜品	
雪梨红枣粥	粥	主食	粥	
雪梨红枣银耳汤	其他甜品	甜点	其他甜品	
雪梨肉饼汤	汤羹	菜品	汤羹	
雪梨胖大海汤	其他甜品	甜点	其他甜品	
雪梨银耳枸杞粥	粥	主食	粥	
雪梨银耳汤	其他甜品	甜点	其他甜品	
雪梨银耳粥	粥	主食	粥	
雪梨雪耳炖尾骨	汤羹	菜品	汤羹	
雪花菜鸡蛋炒饭	炒饭	主食	饭	炒饭
雪菜冬瓜汤	汤羹	菜品	汤羹	
雪菜冬笋拌面	拌面	主食	面	拌面
雪菜冬笋汤	汤羹	菜品	汤羹	
雪菜刀削面	其他面	主食	面	其他面
雪菜墨鱼半汤	汤羹	菜品	汤羹	
雪菜小黄鱼汤	汤羹	菜品	汤羹	
雪菜小黄鱼盖浇饭	盖浇饭	主食	饭	盖浇饭
雪菜小黄鱼面	汤面	主食	面	汤面
雪菜春笋炒鱼片	热菜	菜品	热菜	
雪菜毛豆炒肉丝	热菜	菜品	热菜	
雪菜炒小笋	热菜	菜品	热菜	
雪菜炒山笋	热菜	菜品	热菜	
雪菜炒山药	热菜	菜品	热菜	
雪菜炒平菇	热菜	菜品	热菜	
雪菜炒毛豆	热菜	菜品	热菜	
雪菜炒毛豆米	热菜	菜品	热菜	
雪菜炒笋片	热菜	菜品	热菜	
雪菜炒粉皮	热菜	菜品	热菜	
雪菜炒肉丝	热菜	菜品	热菜	
雪菜炒蘑菇	热菜	菜品	热菜	
雪菜炒蚕豆	热菜	菜品	热菜	
雪菜炒豆芽	热菜	菜品	热菜	
雪菜炖小竹笋汤	热菜	菜品	热菜	
雪菜炖老豆腐	热菜	菜品	热菜	
雪菜炖豆腐	热菜	菜品	热菜	
雪菜煎蛋汤面	汤面	主食	面	汤面
雪菜牛肉粥	粥	主食	粥	
雪菜磨菇豆腐汤	汤羹	菜品	汤羹	
雪菜笋丝炒肉丝	热菜	菜品	热菜	
雪菜笋丝肉丝面	汤面	主食	面	汤面
雪菜笋丝蛋皮汤	汤羹	菜品	汤羹	
雪菜笋子炒肉丝	热菜	菜品	热菜	
雪菜粉丝汤	其他粉	主食	粉	其他粉
雪菜素鸡汤面	汤面	主食	面	汤面
雪菜素鸡面	汤面	主食	面	汤面
雪菜肉丝手擀面	手擀面	主食	面	手擀面
雪菜肉丝菜	热菜	菜品	热菜	
雪菜肉末炒毛豆	热菜	菜品	热菜	
雪菜茭白炒肉丝	热菜	菜品	热菜	
雪菜茭白炒肉片	热菜	菜品	热菜	
雪菜茭白炒豆瓣	热菜	菜品	热菜	
雪菜荷包蛋面	汤面	主食	面	汤面
雪菜菌菇肉片面	盖浇面	主食	面	盖浇面
雪菜藕丝肉丝饭	盖浇饭	主食	饭	盖浇饭
雪菜蘑菇炒肉片	热菜	菜品	热菜	
雪菜蘑菇肉片盖浇饭	盖浇饭	主食	饭	盖浇饭
雪菜蘑菇肉片盖饭	盖浇饭	主食	饭	盖浇饭
雪菜蘑菇虾仁面	汤面	主食	面	汤面
雪菜蘑菇里脊饭	盖浇饭	主食	饭	盖浇饭
雪菜蘑菇面	汤面	主食	面	汤面
雪菜蛋炒米粉	米线	主食	粉	米线
雪菜蛋炒饭	炒饭	主食	饭	炒饭
雪菜蛋皮汤	汤羹	菜品	汤羹	
雪菜蛋花汤	汤羹	菜品	汤羹	
雪菜豆子炒香干	热菜	菜品	热菜	
雪菜豆瓣炒虾仁	热菜	菜品	热菜	
雪菜豆腐汤	汤羹	菜品	汤羹	
雪菜豆腐蛋汤	汤羹	菜品	汤羹	
雪菜豆腐面	汤面	主食	面	汤面
雪菜豌豆米炒鸡蛋	热菜	菜品	热菜	
雪菜里脊炒野笋	热菜	菜品	热菜	
雪菜青椒炒鸡蛋	热菜	菜品	热菜	
雪菜青豆炒肉末	热菜	菜品	热菜	
雪菜鱼片面	汤面	主食	面	汤面
雪菜鸡蛋炒米粉	米线	主食	粉	米线
雪菜鸡蛋炒面	炒面	主食	面	炒面
雪菜鸡蛋炒饭	炒饭	主食	饭	炒饭
雪菜鸡蛋面	汤面	主食	面	汤面
雪菜鸭血豆腐汤	汤羹	菜品	汤羹	
雪菜黄鱼汤	汤羹	菜品	汤羹	
雪菜黄鱼面	汤面	主食	面	汤面
雪里红炖豆腐	热菜	菜品	热菜	
雪里蕻炒肉	热菜	菜品	热菜	
雪里蕻炒鱼片	热菜	菜品	热菜	
雪里蕻炖豆腐	热菜	菜品	热菜	
需要需要大米饭	白米饭	主食	饭	白米饭
需要香米饭	白米饭	主食	饭	白米饭
青咖喱蔬菜	热菜	菜品	热菜	
青小炒菜花	浇头	其他	浇头	
青尖椒炒鸡蛋	热菜	菜品	热菜	
青柿子炒土豆片	热菜	菜品	热菜	
青柿子炒鸡蛋	热菜	菜品	热菜	
青椒丝炒银芽	热菜	菜品	热菜	
青椒土豆丝拌面	拌面	主食	面	拌面
青椒土豆丝炒菜	热菜	菜品	热菜	
青椒土豆丝炒鸡肉丝	热菜	菜品	热菜	
青椒土豆丝盖浇面	盖浇面	主食	面	盖浇面
青椒土豆丝盖浇饭	盖浇饭	主食	饭	盖浇饭
青椒土豆丝盖面	盖浇面	主食	面	盖浇面
青椒土豆丝盖饭	盖浇饭	主食	饭	盖浇饭
青椒土豆丝菜	热菜	菜品	热菜	
青椒土豆丝饭	盖浇饭	主食	饭	盖浇饭
青椒土豆片木桶饭	木桶饭	主食	饭	木桶饭
青椒土豆片盖浇饭	盖浇饭	主食	饭	盖浇饭
青椒土豆片盖饭	盖浇饭	主食	饭	盖浇饭
青椒土豆盖浇饭	盖浇饭	主食	饭	盖浇饭
青椒土豆肉丝盖浇饭	盖浇饭	主食	饭	盖浇饭
青椒土豆肉片小炒	热菜	菜品	热菜	
青椒块炒肉丝	热菜	菜品	热菜	
青椒大头菜	其他包子	主食	包子	其他包子
青椒干丝面	汤面	主食	面	汤面
青椒干子炒肉丝	热菜	菜品	热菜	
青椒木耳炒土鸡蛋	热菜	菜品	热菜	
青椒木耳炒蛋	热菜	菜品	热菜	
青椒木耳炒鸡蛋	热菜	菜品	热菜	
青椒毛豆子炒肉丝	热菜	菜品	热菜	
青椒毛豆炒肉	热菜	菜品	热菜	
青椒毛豆炒肉丝	热菜	菜品	热菜	
青椒炒冬瓜	热菜	菜品	热菜	
青椒炒千张	热菜	菜品	热菜	
青椒炒南瓜丝	热菜	菜品	热菜	
青椒炒卜页	热菜	菜品	热菜	
青椒炒卤干子	热菜	菜品	热菜	
青椒炒土千张	热菜	菜品	热菜	
青椒炒土豆丝	热菜	菜品	热菜	
青椒炒土豆丝小份	热菜	菜品	热菜	
青椒炒土豆小	热菜	菜品	热菜	
青椒炒土豆片	热菜	菜品	热菜	
青椒炒土鸡蛋	热菜	菜品	热菜	
青椒炒干丝	热菜	菜品	热菜	
青椒炒干子	热菜	菜品	热菜	
青椒炒干豆腐	热菜	菜品	热菜	
青椒炒手撕水面筋	热菜	菜品	热菜	
青椒炒木耳	热菜	菜品	热菜	
青椒炒毛豆	热菜	菜品	热菜	
青椒炒毛豆米	热菜	菜品	热菜	
青椒炒水面筋	热菜	菜品	热菜	
青椒炒海带	热菜	菜品	热菜	
青椒炒海带丝	热菜	菜品	热菜	
青椒炒深山河虾干	热菜	菜品	热菜	
青椒炒玉米	热菜	菜品	热菜	
青椒炒瘦肉	热菜	菜品	热菜	
青椒炒白干	热菜	菜品	热菜	
青椒炒笋干	热菜	菜品	热菜	
青椒炒肉丝	热菜	菜品	热菜	
青椒炒肉片	热菜	菜品	热菜	
青椒炒腐竹	热菜	菜品	热菜	
青椒炒芹菜	热菜	菜品	热菜	
青椒炒苦瓜	热菜	菜品	热菜	
青椒炒茄丝	热菜	菜品	热菜	
青椒炒茄子	热菜	菜品	热菜	
青椒炒茶干	热菜	菜品	热菜	
青椒炒荷包蛋	热菜	菜品	热菜	
青椒炒虾米	热菜	菜品	热菜	
青椒炒蛋木桶饭	木桶饭	主食	饭	木桶饭
青椒炒蛋白肉	热菜	菜品	热菜	
青椒炒蛋盖浇面	盖浇面	主食	面	盖浇面
青椒炒蛋盖浇饭	盖浇饭	主食	饭	盖浇饭
青椒炒蛋盖饭	盖浇饭	主食	饭	盖浇饭
青椒炒蛋饭	盖浇饭	菜品	饭	盖浇饭
青椒炒豆干	热菜	菜品	热菜	
青椒炒豆皮	热菜	菜品	热菜	
青椒炒豆腐	热菜	菜品	热菜	
青椒炒豆腐皮	热菜	菜品	热菜	
青椒炒青番茄	热菜	菜品	热菜	
青椒炒青茄子	热菜	菜品	热菜	
青椒炒面筋	热菜	菜品	热菜	
青椒炒香干	热菜	菜品	热菜	
青椒炒香干肉丝	热菜	菜品	热菜	
青椒炒鸡蛋	热菜	菜品	热菜	
青椒炒鸡蛋大份	热菜	菜品	热菜	
青椒炒鸡蛋小份	热菜	菜品	热菜	
青椒炒鸡蛋木桶饭	木桶饭	主食	饭	木桶饭
青椒炒鸡蛋盖浇	盖浇饭	主食	饭	盖浇饭
青椒炒鸡蛋盖浇饭	盖浇饭	菜品	饭	盖浇饭
青椒炒鸡蛋盖码饭	盖浇饭	主食	饭	盖浇饭
青椒炒鸭蛋	热菜	菜品	热菜	
青椒瘦肉拌面	拌面	主食	面	拌面
青椒白菜炒肉丝	热菜	菜品	热菜	
青椒百叶炒肉丝	热菜	菜品	热菜	
青椒磨菇炒肉丝	热菜	菜品	热菜	
青椒笋干面	盖浇面	主食	面	盖浇面
青椒粉条炒牛肉	热菜	菜品	热菜	
青椒素炒杏鲍菇	热菜	菜品	热菜	
青椒肉丝小份菜	热菜	菜品	热菜	
青椒肉丝打卤面	盖浇面	主食	面	盖浇面
青椒肉丝炒刀削	其他面	主食	面	其他面
青椒肉丝炒小笋	热菜	菜品	热菜	
青椒肉丝炒茄丝	热菜	菜品	热菜	
青椒肉丝炒菜	热菜	菜品	热菜	
青椒肉丝炒马桥香干	热菜	菜品	热菜	
青椒胡萝卜大头菜	其他包子	主食	包子	其他包子
青椒腐竹炒肉丝	热菜	菜品	热菜	
青椒芹菜炒肉	热菜	菜品	热菜	
青椒茄子丝面	盖浇面	主食	面	盖浇面
青椒茄子打卤面	盖浇面	主食	面	盖浇面
青椒茄子盖饭	盖浇饭	主食	饭	盖浇饭
青椒茄子饭	盖浇饭	主食	饭	盖浇饭
青椒茭白炒干丝	热菜	菜品	热菜	
青椒茭白炒肉丝	热菜	菜品	热菜	
青椒茶树菇炒肉丝	热菜	菜品	热菜	
青椒蛋炒饭	其他菜品	其他	其他菜品	
青椒韭菜炒蛋	热菜	菜品	热菜	
青椒香干炒笋丝	热菜	菜品	热菜	
青椒香干炒肉	热菜	菜品	热菜	
青椒香干炒肉丝	热菜	菜品	热菜	
青椒香菇炒肉丝	热菜	菜品	热菜	
青椒鸡肉丝盖浇饭	盖浇饭	主食	饭	盖浇饭
青椒鸡蛋打卤面	盖浇面	主食	面	盖浇面
青椒鸡蛋拌面	拌面	主食	面	拌面
青椒鸡蛋炒刀削面	其他面	主食	面	其他面
青椒鸡蛋炒细面	炒面	主食	面	炒面
青椒鸡蛋炒菜不含米饭	热菜	菜品	热菜	
青椒鸡蛋炒面	炒面	主食	面	炒面
青椒鸡蛋炒饭	炒饭	主食	饭	炒饭
青椒鸡蛋盖浇面	盖浇面	主食	面	盖浇面
青椒鸡蛋盖浇饭	盖浇饭	主食	饭	盖浇饭
青椒鸡蛋盖面	盖浇面	主食	面	盖浇面
青椒鸡蛋盖饭	盖浇饭	主食	饭	盖浇饭
青椒鸡蛋米饭	盖浇饭	主食	饭	盖浇饭
青椒鸡蛋饭	盖浇饭	主食	饭	盖浇饭
青火绿豆粥	粥	主食	粥	
青灯黄卷心菜	蔬菜类	烧烤	蔬菜类	
青炒南瓜片	热菜	菜品	热菜	
青炒土豆丝	热菜	菜品	热菜	
青炒大白菜	热菜	菜品	热菜	
青炒大白菜秧子	热菜	菜品	热菜	
青炒小白菜	热菜	菜品	热菜	
青炒小青菜	热菜	菜品	热菜	
青炒手撕包菜	热菜	菜品	热菜	
青炒毛毛菜	热菜	菜品	热菜	
青炒毛白菜	热菜	菜品	热菜	
青炒油麦菜	热菜	菜品	热菜	
青炒白菜苔	热菜	菜品	热菜	
青炒莴苣片	热菜	菜品	热菜	
青炒西兰花	热菜	菜品	热菜	
青瓜山药炒木耳	热菜	菜品	热菜	
青瓜山药炒虾仁	热菜	菜品	热菜	
青瓜木耳炒虾仁	热菜	菜品	热菜	
青瓜木耳炒蛋	热菜	菜品	热菜	
青瓜炒山药	热菜	菜品	热菜	
青瓜炒木耳	热菜	菜品	热菜	
青瓜炒瘦肉	热菜	菜品	热菜	
青瓜炒肉丝	热菜	菜品	热菜	
青瓜炒肉片	热菜	菜品	热菜	
青瓜炒虾仁	热菜	菜品	热菜	
青瓜炒香菇	热菜	菜品	热菜	
青瓜瘦肉汤	汤羹	菜品	汤羹	
青瓜百合炒木耳	热菜	菜品	热菜	
青瓜皮蛋汤	汤羹	菜品	汤羹	
青瓜秋葵炒山药	热菜	菜品	热菜	
青瓜肉片套餐饭	其他饭	主食	饭	其他饭
青瓜肉片汤	汤羹	菜品	汤羹	
青瓜肉片饭	盖浇饭	主食	饭	盖浇饭
青瓜肉羹汤	汤羹	菜品	汤羹	
青禾香米饭	白米饭	主食	饭	白米饭
青笋丝裙带菜	凉菜	菜品	凉菜	
青笋山药炒木耳	热菜	菜品	热菜	
青笋木耳炒肉片	热菜	菜品	热菜	
青笋炒山药	热菜	菜品	热菜	
青笋炒木耳	热菜	菜品	热菜	
青笋炒淮山	热菜	菜品	热菜	
青笋炒肉片	热菜	菜品	热菜	
青笋炒虾仁	热菜	菜品	热菜	
青笋炒香菇	热菜	菜品	热菜	
青笋炒鸡蛋	热菜	菜品	热菜	
青红碎椒炒蛋	热菜	菜品	热菜	
青翠蔬菜粥	粥	主食	粥	
青脆圆白菜	热菜	菜品	热菜	
青花毛芋汤	汤羹	菜品	汤羹	
青芹菜炒肉	热菜	菜品	热菜	
青草猪肚汤	汤羹	菜品	汤羹	
青莱肉丝汤面	汤面	主食	面	汤面
青莱豆腐汤	汤羹	菜品	汤羹	
青菜丸子汤	汤羹	菜品	汤羹	
青菜刀削面	其他面	主食	面	其他面
青菜切碎和饭一起炒	热菜	菜品	热菜	
青菜加饭里面炒	浇头	其他	浇头	
青菜卷子面	汤面	主食	面	汤面
青菜口蘑豆腐汤	汤羹	菜品	汤羹	
青菜圆子汤	汤羹	菜品	汤羹	
青菜土鸡蛋炒面	炒面	主食	面	炒面
青菜大米粥	粥	主食	粥	
青菜小白菜	热菜	菜品	热菜	
青菜山药玉米粥	粥	主食	粥	
青菜山药粥	粥	主食	粥	
青菜平菇汤	汤羹	菜品	汤羹	
青菜平菇泡饭	泡饭	主食	饭	泡饭
青菜排骨粥	粥	主食	粥	
青菜春笋炒油豆腐	热菜	菜品	热菜	
青菜木耳粥	粥	主食	粥	
青菜榨菜豆腐汤	汤羹	菜品	汤羹	
青菜榨菜鸡蛋汤	汤羹	菜品	汤羹	
青菜毛圆汤	汤羹	菜品	汤羹	
青菜汤米面	汤面	主食	面	汤面
青菜油豆腐盖浇饭	盖浇饭	主食	饭	盖浇饭
青菜火腿疙瘩汤	汤羹	菜品	汤羹	
青菜火腿粥	粥	主食	粥	
青菜炒千张	热菜	菜品	热菜	
青菜炒响铃	热菜	菜品	热菜	
青菜炒毛豆	热菜	菜品	热菜	
青菜炒汤子	炒面	主食	面	炒面
青菜炒油豆皮	热菜	菜品	热菜	
青菜炒百叶	热菜	菜品	热菜	
青菜炒百叶丝	热菜	菜品	热菜	
青菜炒百页	热菜	菜品	热菜	
青菜炒皮卷	热菜	菜品	热菜	
青菜炒蘑菇	热菜	菜品	热菜	
青菜炒豆筋	热菜	菜品	热菜	
青菜炒豆腐	热菜	菜品	热菜	
青菜炒豆饼	热菜	菜品	热菜	
青菜炒面筋	热菜	菜品	热菜	
青菜炒香姑	热菜	菜品	热菜	
青菜炒香菇	热菜	菜品	热菜	
青菜煎蛋面	汤面	主食	面	汤面
青菜牛肉盖浇饭	盖浇饭	主食	饭	盖浇饭
青菜牛肉粥	粥	主食	粥	
青菜牛肉面	汤面	主食	面	汤面
青菜牛肉饭	盖浇饭	主食	饭	盖浇饭
青菜猪干汤	汤羹	菜品	汤羹	
青菜玉米双鱼丸粥	粥	主食	粥	
青菜玉米火腿粥	粥	主食	粥	
青菜玉米粥	粥	主食	粥	
青菜玉米香菇粥	粥	主食	粥	
青菜生滚粥	粥	主食	粥	
青菜疙瘩汤	汤羹	菜品	汤羹	
青菜瘦弱粥	粥	主食	粥	
青菜瘦肉汤粉面	汤面	主食	面	汤面
青菜瘦肉粥	粥	主食	粥	
青菜瘦肉蛋花疙瘩汤	汤羹	菜品	汤羹	
青菜皮卷面	汤面	主食	面	汤面
青菜皮蛋瘦肉粥	粥	主食	粥	
青菜皮蛋粥	粥	主食	粥	
青菜笋干面	汤面	主食	面	汤面
青菜粉丝炒肉	热菜	菜品	热菜	
青菜粉丝肉丸汤	汤羹	菜品	汤羹	
青菜粉丝肉圆汤	其他粉	主食	粉	其他粉
青菜素鸡面	汤面	主食	面	汤面
青菜肉丁疙瘩汤	汤羹	菜品	汤羹	
青菜肉丝刀削面	其他面	主食	面	其他面
青菜肉丝榨面汤	其他面	主食	面	其他面
青菜肉丝汤	汤羹	菜品	汤羹	
青菜肉丝汤米面	汤面	主食	面	汤面
青菜肉丝汤面	汤面	主食	面	汤面
青菜肉丝河粉汤	其他粉	主食	粉	其他粉
青菜肉丝泡饭	泡饭	主食	饭	泡饭
青菜肉丝粥	粥	主食	粥	
青菜肉丝蛋汤	汤羹	菜品	汤羹	
青菜肉丝豆腐汤	汤羹	菜品	汤羹	
青菜肉丝豆腐面	汤面	主食	面	汤面
青菜肉丝面	盖浇面	主食	面	盖浇面
青菜肉丸汤	汤羹	菜品	汤羹	
青菜肉圆木耳汤	汤羹	菜品	汤羹	
青菜肉圆汤	汤羹	菜品	汤羹	
青菜肉末粥	粥	主食	粥	
青菜肉沫粥	粥	主食	粥	
青菜肉碎粥	粥	主食	粥	
青菜芋头汤	汤羹	菜品	汤羹	
青菜花炒土鸡蛋	热菜	菜品	热菜	
青菜荷包蛋面	汤面	主食	面	汤面
青菜蘑菇肉丝盖浇饭	盖浇饭	主食	饭	盖浇饭
青菜虾仁粥	粥	主食	粥	
青菜虾米粥	粥	主食	粥	
青菜蛋炒米粉	米线	主食	粉	米线
青菜蛋炒米线	米线	主食	粉	米线
青菜蛋炒粉丝	其他粉	主食	粉	其他粉
青菜蛋炒面	炒面	主食	面	炒面
青菜蛋炒饭	炒饭	主食	饭	炒饭
青菜蛋花汤	汤羹	菜品	汤羹	
青菜蛋花粥	粥	主食	粥	
青菜豆付汤	汤羹	菜品	汤羹	
青菜豆皮炒黑木耳	热菜	菜品	热菜	
青菜豆皮蛋汤	汤羹	菜品	汤羹	
青菜豆腐汤	汤羹	菜品	粉	其他粉
青菜豆腐蛋汤	汤羹	菜品	汤羹	
青菜豆腐鸡蛋汤	汤羹	菜品	汤羹	
青菜金针菇粉丝汤	其他粉	主食	粉	其他粉
青菜青椒炒肉丝	热菜	菜品	热菜	
青菜面泡饭	泡饭	主食	饭	泡饭
青菜飘香牛肉粥	粥	主食	粥	
青菜香煎鸡蛋汤面	汤面	主食	面	汤面
青菜香菇炒面	炒面	主食	面	炒面
青菜香菇炒饭	炒饭	主食	饭	炒饭
青菜香菇瘦肉粥	粥	主食	粥	
青菜香菇粥	粥	主食	粥	
青菜香菇肉丝面	汤面	主食	面	汤面
青菜香菇面	汤面	主食	面	汤面
青菜香菇饭	盖浇饭	主食	饭	盖浇饭
青菜香菇鸡丁粥	粥	主食	粥	
青菜鱼丸汤	汤羹	菜品	汤羹	
青菜鱼片粥	粥	主食	粥	
青菜鲜牛肉蛋炒饭	炒饭	主食	饭	炒饭
青菜鲜牛肉面	汤面	主食	面	汤面
青菜鲜蔬粥	粥	主食	粥	
青菜鲜虾粥	粥	主食	粥	
青菜鸡丝粥	粥	主食	粥	
青菜鸡肉粥	粥	主食	粥	
青菜鸡蛋拉面	拉面	主食	面	拉面
青菜鸡蛋汤	汤羹	菜品	汤羹	
青菜鸡蛋油豆腐汤	汤羹	菜品	汤羹	
青菜鸡蛋泡饭	泡饭	主食	饭	泡饭
青菜鸡蛋炒刀削面	其他面	主食	面	其他面
青菜鸡蛋炒年糕	年糕	主食	年糕	
青菜鸡蛋炒河粉	其他粉	主食	粉	其他粉
青菜鸡蛋炒米面	炒面	主食	面	炒面
青菜鸡蛋炒粉干	米线	主食	粉	米线
青菜鸡蛋炒绿豆皮	热菜	菜品	热菜	
青菜鸡蛋炒豆丝	米线	主食	粉	米线
青菜鸡蛋炒面	炒面	主食	面	炒面
青菜鸡蛋炒饭	炒饭	主食	饭	炒饭
青菜鸡蛋爆炒面	炒面	主食	面	炒面
青菜鸡蛋肉丝炒米面	炒面	主食	面	炒面
青菜鸡蛋肉丝麦面汤	汤面	主食	面	汤面
青菜鸡蛋面	汤面	主食	面	汤面
青菜鸭血汤	汤羹	菜品	汤羹	
青萝卜丝炒千张	热菜	菜品	热菜	
青蒜炒豆丝	热菜	菜品	热菜	
青蒜苗炒鸡蛋	热菜	菜品	热菜	
青蔬口蘑鲜汤	汤羹	菜品	汤羹	
青蔬瘦肉粥	粥	主食	粥	
青虾仁爆炒藕带	热菜	菜品	热菜	
青豆炒肉末	热菜	菜品	热菜	
青豆炒肉沫	热菜	菜品	热菜	
青豆炒虾仁	热菜	菜品	热菜	
青豆玉米炒肉末	热菜	菜品	热菜	
青豆米炒肉丝	热菜	菜品	热菜	
青豆茄丁盖饭	盖浇饭	主食	饭	盖浇饭
青豆虾仁炒蛋	热菜	菜品	热菜	
青雪菜冬笋炒肉丝	热菜	菜品	热菜	
青雪菜炒蘑菇	热菜	菜品	热菜	
青雪菜鲜冬笋面	汤面	主食	面	汤面
青青瓜瓜炒蛋	热菜	菜品	热菜	
青韭炒鸡蛋	热菜	菜品	热菜	
青鱼头豆腐汤	汤羹	菜品	汤羹	
静乐凉拌莜面	其他面	主食	面	其他面
非油炸菠菜面	其他菜品	其他	其他菜品	
非遗黄焖鸡大份不辣含米饭	其他小吃	小吃	其他小吃	
非遗黄焖鸡小份不辣含米饭	热菜	菜品	热菜	
面上煌滋补土鸡面	汤面	主食	面	汤面
面巾香菇面	汤面	主食	面	汤面
面条不要韭菜	蔬菜类	烧烤	蔬菜类	
面条生汆面	汤面	主食	面	汤面
面疙瘩豆腐汤	汤羹	菜品	汤羹	
面筋包炒青菜	热菜	菜品	热菜	
面筋拼小青菜	凉菜	菜品	凉菜	
面筋百叶包粉丝汤	汤羹	菜品	汤羹	
面筋百叶汤	其他主食	主食	其他主食	
面筋百页汤	汤羹	菜品	汤羹	
面结豆面汤	汤面	主食	面	汤面
面结青菜面	汤面	主食	面	汤面
面酱炒番薯叶	热菜	菜品	热菜	
韩国荞面冷面	凉面	主食	面	凉面
韩国荞麦冷面	凉面	主食	面	凉面
韩国荞麦冷面矿泉水汤	凉面	主食	面	凉面
韩式三色拌菜	健康餐	色拉轻食	健康餐	
韩式全素拌饭	拌饭	主食	饭	拌饭
韩式南瓜粥	粥	主食	粥	
韩式海带汤	汤羹	菜品	汤羹	
韩式荞麦冷面	凉面	主食	面	凉面
韩式荞麦鸡丝冷面	凉面	主食	面	凉面
韩式荞麦鸡丝凉拌面	拌面	主食	面	拌面
韩式风味鳕鱼炖豆腐	热菜	菜品	热菜	
韭芽炒鸡蛋	热菜	菜品	热菜	
韭莱沫炒鸡蛋小份	热菜	菜品	热菜	
韭菜末炒蛋	热菜	菜品	热菜	
韭菜末炒鸡蛋	热菜	菜品	热菜	
韭菜段炒鸡蛋	热菜	菜品	热菜	
韭菜沫炒蛋	热菜	菜品	热菜	
韭菜沫炒鸡蛋	热菜	菜品	热菜	
韭菜沬炒鸡蛋	热菜	菜品	热菜	
韭菜炒千张	热菜	菜品	热菜	
韭菜炒南瓜	热菜	菜品	热菜	
韭菜炒土豆	热菜	菜品	热菜	
韭菜炒土豆丝	热菜	菜品	热菜	
韭菜炒土豆片	热菜	菜品	热菜	
韭菜炒土鸡蛋	热菜	菜品	热菜	
韭菜炒小土豆	热菜	菜品	热菜	
韭菜炒小河虾	热菜	菜品	热菜	
韭菜炒干豆腐	热菜	菜品	热菜	
韭菜炒干豆腐皮	热菜	菜品	热菜	
韭菜炒春笋	热菜	菜品	热菜	
韭菜炒河虾	热菜	菜品	热菜	
韭菜炒河虾一份	热菜	菜品	热菜	
韭菜炒猪血	热菜	菜品	热菜	
韭菜炒素鸡	热菜	菜品	热菜	
韭菜炒绿豆芽	热菜	菜品	热菜	
韭菜炒莜面窝	炒面	主食	面	炒面
韭菜炒莴笋丝	热菜	菜品	热菜	
韭菜炒莴苣	热菜	菜品	热菜	
韭菜炒藕丝	热菜	菜品	热菜	
韭菜炒蛋大	热菜	菜品	热菜	
韭菜炒蛋或百叶	热菜	菜品	热菜	
韭菜炒蛋盖米饭	其他菜品	其他	其他菜品	
韭菜炒蛋韭黄炒蛋	热菜	菜品	热菜	
韭菜炒豆干	热菜	菜品	热菜	
韭菜炒豆皮	热菜	菜品	热菜	
韭菜炒豆腐丝	热菜	菜品	热菜	
韭菜炒豆腐皮	热菜	菜品	热菜	
韭菜炒豆芽	热菜	菜品	热菜	
韭菜炒豆芽小炒	热菜	菜品	热菜	
韭菜炒香干	热菜	菜品	热菜	
韭菜炒香干小碗菜	热菜	菜品	热菜	
韭菜炒鸡蛋	热菜	菜品	热菜	
韭菜炒鸡蛋十米饭	其他菜品	其他	其他菜品	
韭菜炒鸡蛋大份	热菜	菜品	热菜	
韭菜炒鸡蛋小份	热菜	菜品	热菜	
韭菜炒鸡蛋小份菜	热菜	菜品	热菜	
韭菜炒鸡鸡蛋	热菜	菜品	热菜	
韭菜炒鸭血	热菜	菜品	热菜	
韭菜炒鸭血小份	热菜	菜品	热菜	
韭菜炒黄豆芽	热菜	菜品	热菜	
韭菜炒黄豆芽小碗菜	热菜	菜品	热菜	
韭菜煎蛋不配饭	热菜	菜品	热菜	
韭菜粉丝炒鸡蛋	热菜	菜品	热菜	
韭菜花炒土鸡蛋	热菜	菜品	热菜	
韭菜豆腐干盖饭	盖浇饭	主食	饭	盖浇饭
韭菜豆芽炒粉条	热菜	菜品	热菜	
韭菜香干炒鸡蛋	热菜	菜品	热菜	
韭菜鸡蛋拌面	拌面	主食	面	拌面
韭菜鸡蛋拌饭	拌饭	主食	饭	拌饭
韭菜鸡蛋盖浇饭	盖浇饭	主食	饭	盖浇饭
韭菜鸡蛋盖饭	盖浇饭	菜品	饭	盖浇饭
韭菜鸡蛋米饭	盖浇饭	主食	饭	盖浇饭
韭菜鸡蛋饭	盖浇饭	主食	饭	盖浇饭
韭菜黄炒鸡蛋	热菜	菜品	热菜	
韭香干炒鲜笋	热菜	菜品	热菜	
韭黄滑蛋炒虾球	热菜	菜品	热菜	
韭黄炒肉丝	热菜	菜品	热菜	
韭黄炒蛋盖饭	盖浇饭	主食	饭	盖浇饭
韭黄炒蛋饭	盖浇饭	主食	饭	盖浇饭
韭黄炒豆腐干	热菜	菜品	热菜	
韭黄炒香干	热菜	菜品	热菜	
韭黄炒香干丝	热菜	菜品	热菜	
韭黄炒鸡蛋	热菜	菜品	热菜	
韭黄虾球炒蛋	热菜	菜品	热菜	
韭黄豆米炒鸡蛋	热菜	菜品	热菜	
韭黄酸辣蛋花汤	汤羹	菜品	汤羹	
韮菜炒肉丝	热菜	菜品	热菜	
韮菜炒鸡蛋	热菜	菜品	热菜	
韮菜豆片丝炒肉	热菜	菜品	热菜	
顶赞姜汤面	米线	主食	粉	米线
顺香居藕汤	汤羹	菜品	汤羹	
预瘦全素拌饭	拌饭	主食	饭	拌饭
风味刀削面	其他面	主食	面	其他面
风味大拌菜	凉菜	菜品	凉菜	
风味小拌菜	凉菜	菜品	凉菜	
风味炒合菜	热菜	菜品	热菜	
风味炒菜花	热菜	菜品	热菜	
风味炒长豆芽	热菜	菜品	热菜	
风味田园小炒	热菜	菜品	热菜	
风味疙瘩汤	汤羹	菜品	汤羹	
风味紫菜汤	汤羹	菜品	汤羹	
风味裙带菜	凉菜	菜品	凉菜	
风味鸡丝荞面	拌面	主食	面	拌面
风扇冷拌素交面	拌面	主食	面	拌面
风生水起捞唐生菜	凉菜	菜品	凉菜	
飘香大米粥	粥	主食	粥	
飘香米饭饭饭饭饭饭饭	白米饭	主食	饭	白米饭
餐餐必吃大米饭	白米饭	主食	饭	白米饭
饭堂香米饭	白米饭	主食	饭	白米饭
饮品拌芹菜	凉菜	菜品	凉菜	
饱腹杂粮饭	健康餐	色拉轻食	健康餐	
饱腹番茄挂面汤	汤面	主食	面	汤面
饼加炒土豆丝	夹饼/夹馍	主食	饼/囊/馍	夹饼/夹馍
饼里加生菜	浇头	其他	浇头	
馄炖鸡蛋汤	馄饨	主食	馄饨	
馄饨加蛋花汤	其他菜品	其他	其他菜品	
馄饨加青菜	馄饨	主食	馄饨	
馕炒圆白菜	热菜	菜品	热菜	
馕炒莲花白	热菜	菜品	热菜	
首长健康蒸菜	热菜	菜品	热菜	
香其酱炒鸡蛋	热菜	菜品	热菜	
香叶海白菜	热菜	菜品	热菜	
香喷喷东北大米饭	白米饭	主食	饭	白米饭
香喷喷东北米饭	白米饭	主食	饭	白米饭
香喷喷大米饭	白米饭	主食	饭	白米饭
香喷喷白米饭	白米饭	主食	饭	白米饭
香喷喷的五常米大米饭	白米饭	主食	饭	白米饭
香喷喷的大米饭	白米饭	主食	饭	白米饭
香喷喷的小份米饭	白米饭	主食	饭	白米饭
香喷喷的白米饭	白米饭	主食	饭	白米饭
香喷喷的的白米饭	白米饭	主食	饭	白米饭
香喷喷的米饭	白米饭	主食	饭	白米饭
香喷喷的蒸饭	白米饭	主食	饭	白米饭
香喷喷的黑米饭	白米饭	主食	饭	白米饭
香喷喷稻花香米饭	白米饭	主食	饭	白米饭
香喷喷米饭	白米饭	主食	饭	白米饭
香喷喷长粒香米饭	白米饭	主食	饭	白米饭
香喷豆角饭	盖浇饭	主食	饭	盖浇饭
香噴噴大米饭	白米饭	主食	饭	白米饭
香嫩娃娃菜	蔬菜类	烧烤	蔬菜类	
香干拼野菜	凉菜	菜品	凉菜	
香干炒三丝	热菜	菜品	热菜	
香干炒毛豆	热菜	菜品	热菜	
香干炒肉丝	热菜	菜品	热菜	
香干炒肉丝芹菜	热菜	菜品	热菜	
香干炒芹菜	热菜	菜品	热菜	
香干炒芹菜盖饭	盖浇饭	主食	饭	盖浇饭
香干炒青椒	热菜	菜品	热菜	
香干炒韭菜	热菜	菜品	热菜	
香干炒马兰头	热菜	菜品	热菜	
香干芹菜炒肉	热菜	菜品	热菜	
香干芹菜炒肉丝	热菜	菜品	热菜	
香干芹菜盖饭	盖浇饭	主食	饭	盖浇饭
香拌圆白菜	凉菜	菜品	凉菜	
香拌山野菜	凉菜	菜品	凉菜	
香春头炒鸡蛋	热菜	菜品	热菜	
香春芽炒鸡蛋	热菜	菜品	热菜	
香椿头炒土鸡蛋	热菜	菜品	热菜	
香椿头炒鸡蛋	热菜	菜品	热菜	
香椿炒土鸡蛋	热菜	菜品	热菜	
香椿炒鸡蛋	热菜	菜品	热菜	
香椿芽炒蛋	热菜	菜品	热菜	
香椿芽炒鸡蛋	热菜	菜品	热菜	
香椿芽炒鸡蛋卷	卷饼	主食	饼/囊/馍	卷饼
香椿苗炒滑蛋	热菜	菜品	热菜	
香椿苗炒鸡蛋	热菜	菜品	热菜	
香汁海白菜	凉菜	菜品	凉菜	
香江大拌菜	凉菜	菜品	凉菜	
香油拌生菜	凉菜	菜品	凉菜	
香油捞青菜	热菜	菜品	热菜	
香浓番茄汤	汤羹	菜品	汤羹	
香浓番茄鸡蛋汤	汤羹	菜品	汤羹	
香浓黑米粥	粥	主食	粥	
香港味道罗宋汤	汤羹	菜品	汤羹	
香港艇仔粥	粥	主食	粥	
香溢豆腐汤	汤羹	菜品	汤羹	
香滑野菌汤	汤羹	菜品	汤羹	
香滑鸡丝粥	粥	主食	粥	
香滑鸡皇粥	粥	主食	粥	
香炒桑巴空心菜	热菜	菜品	热菜	
香炒芥菜丝	热菜	菜品	热菜	
香炖干豆腐	热菜	菜品	热菜	
香煎三文鱼饭	盖浇饭	主食	饭	盖浇饭
香煎大虾杂粮饭	健康餐	色拉轻食	健康餐	
香煎马鲛鱼饭	盖浇饭	主食	饭	盖浇饭
香煎鲭鱼饭	其他饭	主食	饭	其他饭
香煎鳕鱼饭	盖浇饭	菜品	饭	盖浇饭
香煎鸡胸低卡拌饭	健康餐	色拉轻食	健康餐	
香煎鸡胸糙米饭	健康餐	色拉轻食	健康餐	
香煎黄米饭	白米饭	主食	饭	白米饭
香甜五仁粥	粥	主食	粥	
香甜五谷八宝粥	粥	主食	粥	
香甜八宝粥	粥	主食	粥	
香甜南瓜粥	粥	主食	粥	
香甜地瓜粥	粥	主食	粥	
香甜大头菜	蔬菜类	烧烤	蔬菜类	
香甜大米饭	白米饭	主食	饭	白米饭
香甜大麦粥	粥	主食	粥	
香甜小米粥	粥	主食	粥	
香甜有机大米饭	白米饭	主食	饭	白米饭
香甜玉米粥	粥	主食	粥	
香甜玫瑰粥	粥	主食	粥	
香甜白米饭	白米饭	主食	饭	白米饭
香甜紫薯粥	粥	主食	粥	
香甜红薯汤	糖水/炖品	甜点	糖水/炖品	
香甜红豆小米粥	粥	主食	粥	
香甜腊八粥	粥	主食	粥	
香甜裙带菜	凉菜	菜品	凉菜	
香甜金瓜粥	粥	主食	粥	
香甜青菜瘦肉粥	粥	主食	粥	
香甜黑米粥	粥	主食	粥	
香稠南瓜粥	粥	主食	粥	
香米米米饭	白米饭	主食	饭	白米饭
香米青菜粥	粥	主食	粥	
香糯南瓜粥	粥	主食	粥	
香糯地瓜粥	粥	主食	粥	
香糯白米饭	白米饭	主食	饭	白米饭
香糯红豆粥	粥	主食	粥	
香糯麦芽粥	粥	主食	粥	
香糯黑米粥	粥	主食	粥	
香肉汤炖豆腐	热菜	菜品	热菜	
香肉豆腐汤	汤羹	菜品	汤羹	
香脆木耳菜	凉菜	菜品	凉菜	
香芋牛肉粥	粥	主食	粥	
香芋粥十瘦肉十青菜	粥	主食	粥	
香芋黑糯米粥	粥	主食	粥	
香芹木耳炒山药	热菜	菜品	热菜	
香芹木耳炒肉盖饭	盖浇饭	主食	饭	盖浇饭
香芹炒木耳	热菜	菜品	热菜	
香芹炒笋丝	热菜	菜品	热菜	
香芹炒肉丝	热菜	菜品	热菜	
香芹炒藕丝	热菜	菜品	热菜	
香芹炒虾仁	热菜	菜品	热菜	
香芹炒豆干	热菜	菜品	热菜	
香芹炒豆皮	热菜	菜品	热菜	
香芹炒香干	热菜	菜品	热菜	
香芹肉丝小份菜	热菜	菜品	热菜	
香芹肉丝炒豆干	热菜	菜品	热菜	
香芹肉丝饭	盖浇饭	主食	饭	盖浇饭
香芹菜炒肉片	热菜	菜品	热菜	
香芹豆干木桶饭	木桶饭	主食	饭	木桶饭
香芹青椒炒肉	热菜	菜品	热菜	
香茅炒虾仁	热菜	菜品	热菜	
香茅炒鸡肉	热菜	菜品	热菜	
香茹老鸭汤	汤羹	菜品	汤羹	
香莴笋炒肉	热菜	菜品	热菜	
香莴笋炒肉丝	热菜	菜品	热菜	
香莴笋炒蛋	热菜	菜品	热菜	
香菇一份炒进饭里	其他菜品	其他	其他菜品	
香菇丸子烩菜	热菜	菜品	热菜	
香菇乌鸡汤	汤羹	菜品	汤羹	
香菇冷拌面	拌面	主食	面	拌面
香菇圆百菜盖饭	盖浇饭	主食	饭	盖浇饭
香菇土豆炖鸡	热菜	菜品	热菜	
香菇土豆片炒肉	热菜	菜品	热菜	
香菇土豆牛肉饭	盖浇饭	主食	饭	盖浇饭
香菇土豆饭	盖浇饭	主食	饭	盖浇饭
香菇土鸡汤	汤羹	菜品	汤羹	
香菇土鸡粥	粥	主食	粥	
香菇大头菜	其他包子	主食	包子	其他包子
香菇娃娃菜	热菜	菜品	热菜	其他包子
香菇嫩鸡粥	粥	主食	粥	
香菇小塘菜	热菜	菜品	热菜	
香菇小排粥	粥	主食	粥	
香菇小油菜	热菜	菜品	热菜	
香菇小白菜	饺子	菜品	饺子	
香菇小肠瘦肉粥	粥	主食	粥	
香菇小青菜	热菜	菜品	热菜	
香菇小青菜盖饭	盖浇饭	主食	饭	盖浇饭
香菇干贝瘦肉粥	粥	主食	粥	
香菇干贝粥	粥	主食	粥	
香菇干贝青菜粥	粥	主食	粥	
香菇廋肉粥	粥	主食	粥	
香菇扒油菜	热菜	菜品	热菜	
香菇扒白菜	热菜	菜品	热菜	
香菇排骨汤	汤羹	菜品	汤羹	
香菇排骨粥	粥	主食	粥	
香菇既鸡丁盖饭	盖浇饭	主食	饭	盖浇饭
香菇有机小青菜	热菜	菜品	热菜	
香菇木耳炒肉	热菜	菜品	热菜	
香菇板栗鸡腿饭	盖浇饭	主食	饭	盖浇饭
香菇枸杞土鸡汤	汤羹	菜品	汤羹	
香菇油菜心饭	盖浇饭	主食	饭	盖浇饭
香菇油菜盖浇饭	盖浇饭	主食	饭	盖浇饭
香菇油菜盖饭	盖浇饭	主食	饭	盖浇饭
香菇海蛎汤	汤羹	菜品	汤羹	
香菇清汤面	汤面	主食	面	汤面
香菇滑鸡丝粥	粥	主食	粥	
香菇滑鸡小碗菜	盖浇饭	主食	饭	盖浇饭
香菇滑鸡木桶饭	木桶饭	主食	饭	木桶饭
香菇滑鸡盖浇套餐饭	盖浇饭	主食	饭	盖浇饭
香菇滑鸡盖浇饭	盖浇饭	主食	饭	盖浇饭
香菇滑鸡盖饭	盖浇饭	主食	饭	盖浇饭
香菇滑鸡粥	粥	主食	粥	
香菇滑鸡荷叶蒸饭	焖饭	主食	饭	焖饭
香菇滑鸡蒸饭	盖浇饭	主食	饭	盖浇饭
香菇滑鸡饭	盖浇饭	主食	饭	盖浇饭
香菇火腿粥	粥	主食	粥	
香菇炒杂蔬	热菜	菜品	热菜	
香菇炒油菜	热菜	菜品	热菜	
香菇炒白菜片	热菜	菜品	热菜	
香菇炒肉丝	热菜	菜品	热菜	
香菇炒肉小份	热菜	菜品	热菜	
香菇炒肉片	热菜	菜品	热菜	
香菇炒肉盖饭	盖浇饭	主食	饭	盖浇饭
香菇炒腐竹	热菜	菜品	热菜	
香菇炒芹菜	热菜	菜品	热菜	
香菇炒莴笋	热菜	菜品	热菜	
香菇炒菜柳	热菜	菜品	热菜	
香菇炒菜胆	热菜	菜品	热菜	
香菇炒西蓝花	热菜	菜品	热菜	
香菇炒青菜	热菜	菜品	热菜	
香菇炒鸡毛菜	热菜	菜品	热菜	
香菇炒鸡肉	热菜	菜品	热菜	
香菇炒鸡蛋	热菜	菜品	热菜	
香菇炖鸡块	热菜	菜品	热菜	
香菇炖鸡汤	汤羹	菜品	汤羹	
香菇炖鸡砂锅	热菜	菜品	热菜	
香菇炖鸡面	汤面	主食	面	汤面
香菇烧油菜	热菜	菜品	热菜	
香菇牛肉砂锅粥	粥	主食	粥	
香菇牛肉粥	粥	主食	粥	
香菇牛肉青菜粥	粥	主食	粥	
香菇玉米廋肉粥	粥	主食	粥	
香菇玉米排骨粥	粥	主食	粥	
香菇玉米粥	粥	主食	粥	
香菇瘦肉粥	粥	主食	粥	
香菇瘦肉蒸饭	焖饭	主食	饭	焖饭
香菇瘦肉蛋花疙瘩汤	汤羹	菜品	汤羹	
香菇白菜炖千张	热菜	菜品	热菜	
香菇皮蛋粥	粥	主食	粥	
香菇秋葵小炒肉	热菜	菜品	热菜	
香菇笋片虾仁面	汤面	主食	面	汤面
香菇粉条炖鸡	热菜	菜品	热菜	
香菇粉皮炖黑爪鸡	其他菜品	其他	其他菜品	
香菇素菜粥	粥	主食	粥	
香菇红枣土鸡汤	汤羹	菜品	汤羹	
香菇老鸭汤	汤羹	菜品	汤羹	
香菇肉丁鱼汤面	汤面	主食	面	汤面
香菇肉丝十米饭	盖浇饭	主食	饭	盖浇饭
香菇肉丝手擀汤面	手擀面	主食	面	手擀面
香菇肉丝手擀面汤面	手擀面	主食	面	手擀面
香菇肉丝汤	汤羹	菜品	汤羹	
香菇肉丝汤面	汤面	主食	面	汤面
香菇肉丝泡饭	泡饭	主食	饭	泡饭
香菇肉丝炒粉干	米线	主食	粉	米线
香菇肉丝炒面	炒面	主食	面	炒面
香菇肉丝盖浇饭	盖浇饭	主食	饭	盖浇饭
香菇肉丝盖饭	盖浇饭	主食	饭	盖浇饭
香菇肉丝粥	粥	主食	粥	
香菇肉丝面	盖浇面	主食	面	盖浇面
香菇肉丝饭	盖浇饭	主食	饭	盖浇饭
香菇肉丸汤	汤羹	菜品	汤羹	
香菇肉丸青菜汤	汤羹	菜品	汤羹	
香菇肉打卤面	盖浇面	主食	面	盖浇面
香菇肉末粥	粥	主食	粥	
香菇肉松粥	粥	主食	粥	
香菇肉滑汤	汤羹	菜品	汤羹	
香菇肉片汤	汤羹	菜品	汤羹	
香菇肉片盖浇饭	盖浇饭	主食	饭	盖浇饭
香菇肉片饭	盖浇饭	主食	饭	盖浇饭
香菇肉碎面	汤面	主食	面	汤面
香菇肉粒饭	盖浇饭	主食	饭	盖浇饭
香菇肉蓉汤	汤羹	菜品	汤羹	
香菇肉饼汤	汤羹	菜品	汤羹	
香菇肚片汤	汤羹	菜品	汤羹	
香菇茄丁盖饭	盖浇饭	主食	饭	盖浇饭
香菇菜粒粥	粥	主食	粥	
香菇蔬菜粥	粥	主食	粥	
香菇蕃茄川元汤	汤羹	菜品	汤羹	
香菇薏仁粥	粥	主食	粥	
香菇虾仁粥	粥	主食	粥	
香菇虾段炒青菜	热菜	菜品	热菜	
香菇虾米粥	粥	主食	粥	
香菇蛋炒饭	炒饭	主食	饭	炒饭
香菇蛋花砂锅粥	粥	主食	粥	
香菇豆腐汤	汤羹	菜品	汤羹	
香菇豆腐肉碎饭	盖浇饭	主食	饭	盖浇饭
香菇豆腐青菜汤	汤羹	菜品	汤羹	
香菇贡丸汤	汤羹	菜品	汤羹	
香菇趴油菜	热菜	菜品	热菜	
香菇青菜木桶饭	木桶饭	主食	饭	木桶饭
香菇青菜汤	汤羹	菜品	汤羹	
香菇青菜汤面	汤面	主食	面	汤面
香菇青菜瘦肉粥	粥	主食	粥	
香菇青菜盖浇饭	盖浇饭	主食	饭	盖浇饭
香菇青菜盖饭	盖浇饭	主食	饭	盖浇饭
香菇青菜石锅汤	汤羹	菜品	汤羹	
香菇青菜粥	粥	主食	粥	
香菇青菜肉末粥	粥	主食	粥	
香菇青菜面	汤面	主食	面	汤面
香菇青菜饭	盖浇饭	主食	饭	盖浇饭
香菇青菜鸡肉粥	粥	主食	粥	
香菇面筋冷面	凉面	主食	面	凉面
香菇面筋汤面	汤面	主食	面	汤面
香菇面筋素鸡拌面	拌面	主食	面	拌面
香菇面筋面	盖浇面	主食	面	盖浇面
香菇面筋饭	盖浇饭	主食	饭	盖浇饭
香菇鱼片粥	粥	主食	粥	
香菇鲜虾粥	粥	主食	粥	
香菇鸡丁粥	粥	主食	粥	
香菇鸡丁面	盖浇面	主食	面	盖浇面
香菇鸡丁饭	浇头	其他	浇头	
香菇鸡丝手擀面	手擀面	主食	面	手擀面
香菇鸡丝汤面	汤面	主食	面	汤面
香菇鸡丝盖饭	盖浇饭	主食	饭	盖浇饭
香菇鸡丝粥	粥	主食	粥	
香菇鸡丝面	汤面	主食	面	汤面
香菇鸡毛菜	热菜	菜品	热菜	
香菇鸡汤刀削面	其他面	主食	面	其他面
香菇鸡汤面	汤面	主食	面	汤面
香菇鸡粒粥	粥	主食	粥	
香菇鸡肉粥	粥	主食	粥	
香菇鸡肉面	盖浇面	主食	面	盖浇面
香菇鸡肉饭	盖浇饭	主食	饭	盖浇饭
香菇鸡腿面	汤面	主食	面	汤面
香菇鸡蛋面	汤面	主食	面	汤面
香菇鸭肉饭	盖浇饭	主食	饭	盖浇饭
香菇黄白菜	热菜	菜品	热菜	
香菜炒千张	热菜	菜品	热菜	
香菜牛肉粥	粥	主食	粥	
香菜粉皮炒肉丝	热菜	菜品	热菜	
香菜肉丝粥	粥	主食	粥	
香菜肉丝豆腐汤	汤羹	菜品	汤羹	
香菜花蛤豆腐汤	汤羹	菜品	汤羹	
香菜豆腐汤	汤羹	菜品	汤羹	
香菜豆腐鱼头汤	汤羹	菜品	汤羹	
香菜鱼头豆腐汤	汤羹	菜品	汤羹	
香葱木耳炒肉	热菜	菜品	热菜	
香葱木耳炒鸡蛋	热菜	菜品	热菜	
香葱油炒莜面	炒面	主食	面	炒面
香葱炒土鸡蛋	热菜	菜品	热菜	
香葱炒山鸡蛋	热菜	菜品	热菜	
香葱炒木耳	热菜	菜品	热菜	
香葱炒河虾	热菜	菜品	热菜	
香葱炒笨鸡蛋	热菜	菜品	热菜	
香葱炒鸡蛋	热菜	菜品	热菜	
香葱蛋炒饭	炒饭	主食	饭	炒饭
香葱蛋花炒饭	炒饭	主食	饭	炒饭
香蕉牛奶燕麦粥	粥	主食	粥	
香醇黑米粥	粥	主食	粥	
香醋果仁菠菜	凉菜	菜品	凉菜	
香醋炒山药	热菜	菜品	热菜	
香醋炒鸡蛋	热菜	菜品	热菜	
香醋豆芽菜	凉菜	菜品	凉菜	
香钵高山花菜	热菜	菜品	热菜	
香锅开心花菜	蔬菜类	菜品	配菜	蔬菜类
香锅手撕包菜	热菜	菜品	热菜	
香锅有机花菜	热菜	菜品	热菜	
香香大米饭	白米饭	主食	饭	白米饭
香香玉米饭	白米饭	主食	饭	白米饭
香香白米饭	白米饭	主食	饭	白米饭
香香的大米饭	白米饭	主食	饭	白米饭
香香的白米饭	白米饭	主食	饭	白米饭
香香的米饭饭	白米饭	主食	饭	白米饭
香鲜疙瘩汤	汤羹	菜品	汤羹	
马兰头炒香干	热菜	菜品	热菜	
马兰头炒香干丝	热菜	菜品	热菜	
马家沟芹菜	热菜	菜品	热菜	
马家沟芹菜炒土豆丝	热菜	菜品	热菜	
马拉酱花菜	热菜	菜品	热菜	
马架炒芹菜	热菜	菜品	热菜	
马蹄木耳炒肉片	热菜	菜品	热菜	
马蹄炖红枣	热菜	菜品	热菜	
马鲛鱼丸汤	汤羹	菜品	汤羹	
马鲛鱼烧酸菜	热菜	菜品	热菜	
驱寒红糖蜜枣粥	粥	主食	粥	
驴骨豆腐汤	汤羹	菜品	汤羹	
骨头海带瓦罐汤	汤羹	菜品	汤羹	
骨头紫菜汤	汤羹	菜品	汤羹	
骨头莲藕汤	汤羹	菜品	汤羹	
骨头萝卜汤	汤羹	菜品	汤羹	
骨头萝卜瓦罐汤	汤羹	菜品	汤羹	
骨头黄豆汤	汤羹	菜品	汤羹	
骨架炖酸菜	热菜	菜品	热菜	
骨汤炖小白菜	热菜	菜品	热菜	
骨汤炖海带苗	汤羹	菜品	汤羹	
骨汤炖白菜	热菜	菜品	热菜	
骨汤老豆腐炖白菜	热菜	菜品	热菜	
骨汤营养面	汤面	主食	面	汤面
骨汤豆腐炖白菜	热菜	菜品	热菜	
骨汤鸡蛋汤	汤羹	菜品	汤羹	
高丽娃娃菜	蔬菜类	火锅/串串/麻辣烫/色拉自选	配菜	蔬菜类
高丽锅大米饭	白米饭	主食	饭	白米饭
高原娃娃菜	蔬菜类	火锅/串串/麻辣烫/色拉自选	配菜	蔬菜类
高安腐竹丨经典地方菜	热菜	菜品	热菜	
高山地娃娃菜	蔬菜类	烧烤	蔬菜类	
高山娃娃菜	蔬菜类	菜品	配菜	蔬菜类
高山娃娃菜清炒	热菜	菜品	热菜	
高山小白菜	蔬菜类	火锅/串串/麻辣烫/色拉自选	配菜	蔬菜类
高梁米水饭	白米饭	主食	饭	白米饭
高汤娃娃菜	热菜	菜品	热菜	
高汤杂菌面	汤面	主食	面	汤面
高汤番茄西红柿蛋花汤	汤羹	菜品	汤羹	
高汤紫菜蛋花汤	汤羹	菜品	汤羹	
高汤芸豆面	汤面	主食	面	汤面
高汤鸡蛋汤	汤羹	菜品	汤羹	
高粮米水饭	其他饭	主食	饭	其他饭
高粱水米饭	白米饭	主食	饭	白米饭
高粱米水饭	白米饭	主食	饭	白米饭
高粱薏米粥	粥	主食	粥	
高纤藜麦燕麦牛奶粥	粥	主食	粥	
高营养的黑麦粥	粥	主食	粥	
高邮阳春面	汤面	主食	面	汤面
鮟鱇鱼炖豆腐	热菜	菜品	热菜	
鮸鱼鱼圆面	汤面	主食	面	汤面
鱈鱼炖豆腐	热菜	菜品	热菜	
鱼丸三鲜汤	汤羹	菜品	汤羹	
鱼丸大白菜	热菜	菜品	热菜	
鱼丸扁食汤	馄饨	主食	馄饨	
鱼丸海带豆腐汤	汤羹	菜品	汤羹	
鱼丸炖小白菜	热菜	菜品	热菜	
鱼丸烧海带苗汤	汤羹	菜品	汤羹	
鱼丸粉丝汤	其他粉	主食	粉	其他粉
鱼丸紫菜汤	汤羹	菜品	汤羹	
鱼丸菠菜粉汤	米线	主食	粉	米线
鱼丸青菜汤	汤羹	菜品	汤羹	
鱼头专用手擀面	其他面	主食	面	其他面
鱼头炖豆腐	热菜	菜品	热菜	
鱼头炖豆腐汤	汤羹	菜品	汤羹	
鱼头豆腐汤	汤羹	菜品	汤羹	
鱼头鲜虾粥	粥	主食	粥	
鱼排豆腐汤	汤羹	菜品	汤羹	
鱼杂炖豆腐	热菜	菜品	热菜	
鱼汤肉丝面	汤面	主食	面	汤面
鱼汤黄鱼面	汤面	主食	面	汤面
鱼片炒虾仁	热菜	菜品	热菜	
鱼片鲜虾粥	粥	主食	粥	
鱼皮饺紫菜汤	饺子	主食	饺子	
鱼米炒甜青豆	热菜	菜品	热菜	
鱼米香芋头饭	焖饭	主食	饭	焖饭
鱼羹虾仁蛋汤	汤羹	菜品	汤羹	
鱼肉两鲜面	汤面	主食	面	汤面
鱼肉丸砂锅粥	粥	主食	粥	
鱼豆腐炒杏鲍菇	热菜	菜品	热菜	
鱼豆腐炒芹菜	热菜	菜品	热菜	
鱼豆腐疙瘩汤	汤羹	菜品	汤羹	
鱼豆腐芹菜	热菜	菜品	热菜	
鱼饼乌冬汤面	乌冬面	主食	面	乌冬面
鱼饼乌冬面	乌冬面	主食	面	乌冬面
鱼饼炒花菜	热菜	菜品	热菜	
鱼香烧汁莜面	盖浇面	主食	面	盖浇面
鱼香素丝盖浇饭	盖浇饭	主食	饭	盖浇饭
鱼香肉丝小碗菜	热菜	菜品	热菜	
鱼香肉丝干煸豆角麻婆豆腐米饭	其他菜品	其他	其他菜品	
鱼香肉丝菜	热菜	菜品	热菜	
鱼香茄子十米饭	其他菜品	其他	其他菜品	
鱼香茄子恋米饭	盖浇饭	主食	饭	盖浇饭
鱼香茄子盖浇饭	盖浇饭	主食	饭	盖浇饭
鱼香茄子饭	盖浇饭	主食	饭	盖浇饭
鱼香茄条盖浇饭	盖浇饭	主食	饭	盖浇饭
鱼香茄条盖饭	盖浇饭	主食	饭	盖浇饭
鱼香茄条饭	盖浇饭	主食	饭	盖浇饭
鱼香鸡丝小份菜	热菜	菜品	热菜	
鱼香鸡丝小炒加米饭	其他菜品	其他	其他菜品	
鱼香鸡丝小炒十米饭十饮料	热菜	菜品	热菜	
鱼香鸡丝小碗菜	热菜	菜品	热菜	
鱼香鸡丝炒菜	热菜	菜品	热菜	
鱼香鸡蛋饭	盖浇饭	主食	饭	盖浇饭
鱼骨味增汤	汤羹	菜品	汤羹	
鱼骨鱼腩粥	粥	主食	粥	
鱿鱼丝炒豆芽	热菜	菜品	热菜	
鱿鱼干炒芹菜	热菜	菜品	热菜	
鱿鱼抄芹菜	热菜	菜品	热菜	
鱿鱼拌芹菜	凉菜	菜品	凉菜	
鱿鱼炒芹菜	热菜	菜品	热菜	
鱿鱼炒西兰花	热菜	菜品	热菜	
鱿鱼烧芹菜	热菜	菜品	热菜	
鱿鱼虾仁粥	粥	主食	粥	
鲅鱼炖豆一条	热菜	菜品	热菜	
鲅鱼炖豆腐	热菜	菜品	热菜	
鲅鱼鱼丸汤	汤羹	菜品	汤羹	
鲈鱼砂锅粥	粥	主食	粥	
鲈鱼豆腐汤	汤羹	菜品	汤羹	
鲍汁娃娃菜	热菜	菜品	热菜	
鲍鱼干贝粥	粥	主食	粥	
鲍鱼海参粥	粥	主食	粥	
鲍鱼海鲜粥	粥	主食	粥	
鲍鱼炒鸡纵菌	热菜	菜品	热菜	
鲍鱼虾仁鱼片粥	粥	主食	粥	
鲍鱼鲜虾粥	粥	主食	粥	
鲜人参乌鸡汤	汤羹	菜品	汤羹	
鲜冬菇焖鸡饭	盖浇饭	主食	饭	盖浇饭
鲜味凉瓜炒鸡蛋	热菜	菜品	热菜	
鲜味拌花菜	凉菜	菜品	凉菜	
鲜味疙瘩汤	汤羹	菜品	汤羹	
鲜味香菇罐罐面	汤面	主食	面	汤面
鲜味鱼片粥	粥	主食	粥	
鲜奶八宝粥	粥	主食	粥	
鲜奶南瓜粥	粥	主食	粥	
鲜奶燕麦粥	粥	主食	粥	
鲜奶红豆薏米粥	粥	主食	粥	
鲜奶黑米粥	粥	主食	粥	
鲜嫩娃娃菜	蔬菜类	火锅/串串/麻辣烫/色拉自选	配菜	蔬菜类
鲜嫩小青菜	浇头	其他	浇头	
鲜嫩油麦菜	蔬菜类	火锅/串串/麻辣烫/色拉自选	配菜	蔬菜类
鲜山药瘦肉粥	粥	主食	粥	
鲜川豆炒韭菜	热菜	菜品	热菜	
鲜扇贝干贝粥	粥	主食	粥	
鲜扇贝肉饼青菜粥	粥	主食	粥	
鲜拌什锦菜	凉菜	菜品	凉菜	
鲜掉眉毛的排骨炖芋头	热菜	菜品	热菜	
鲜有基枣仁百合参鸡汤	汤羹	菜品	汤羹	
鲜松茸炒芦笋	热菜	菜品	热菜	
鲜果时蔬大拌菜	凉菜	菜品	凉菜	
鲜桃仁炒木耳	热菜	菜品	热菜	
鲜椒娃娃菜	热菜	菜品	热菜	
鲜汁金针娃娃菜	热菜	菜品	热菜	
鲜汤三鲜面	汤面	主食	面	汤面
鲜汤大白菜炖豆腐	热菜	菜品	热菜	
鲜汤黄花面	汤面	主食	面	汤面
鲜活黑鱼片粥	粥	主食	粥	
鲜淮山清补凉煲竹丝鸡汤	汤羹	菜品	汤羹	
鲜滑海鲜粥	粥	主食	粥	
鲜滑鱼片粥	粥	主食	粥	
鲜炒杏鲍菇	热菜	菜品	热菜	
鲜炒酸辣大白菜	热菜	菜品	热菜	
鲜炖卤鸡蛋	浇头	其他	浇头	
鲜炖燕窝食用方法	其他甜品	甜点	其他甜品	
鲜炖牛奶桃胶炖雪燕	其他甜品	甜点	其他甜品	
鲜炖竹荪炖老鸡汤	汤羹	菜品	汤羹	
鲜炖红糖枸杞燕窝	其他甜品	甜点	其他甜品	
鲜煮萝卜汤	汤羹	菜品	汤羹	
鲜玉米糯米粥	粥	主食	粥	
鲜番茄鸡蛋汤	汤羹	菜品	汤羹	
鲜番茄鸡蛋蔬菜拌面	拌面	主食	面	拌面
鲜百合淮山肉片粥	粥	主食	粥	
鲜秋葵炒肉	热菜	菜品	热菜	
鲜粉卷心菜	热菜	菜品	热菜	
鲜粉皮炒芹菜	热菜	菜品	热菜	
鲜美疙瘩汤	汤羹	菜品	汤羹	
鲜美菌菇汤	汤羹	菜品	汤羹	
鲜肉大白菜	饺子	主食	饺子	
鲜肉小白菜	饺子	主食	饺子	
鲜肉海带苗汤	汤羹	菜品	汤羹	
鲜肉香菇油菜	饺子	主食	饺子	
鲜腐竹炖肚条	热菜	菜品	热菜	
鲜芦笋炒肉丝	热菜	菜品	热菜	
鲜芦笋炒草菇	热菜	菜品	热菜	
鲜苦瓜炒蛋	热菜	菜品	热菜	
鲜茄丝瓜炒蛋	热菜	菜品	热菜	
鲜茶树菇炒肉片饭	盖浇饭	主食	饭	盖浇饭
鲜菇乌冬面	乌冬面	主食	面	乌冬面
鲜菇菌味汤面	汤面	主食	面	汤面
鲜菇虾仁粥	粥	主食	粥	
鲜菇鸡肉粥	粥	主食	粥	
鲜菌炒菜心	热菜	菜品	热菜	
鲜菌素拌面	拌面	主食	面	拌面
鲜菌虫草花汤	汤羹	菜品	汤羹	
鲜蔬煎鸡饭	盖浇饭	主食	饭	盖浇饭
鲜蔬肉丸汤	汤羹	菜品	汤羹	
鲜蔬肉沫什锦拌饭	拌饭	主食	饭	拌饭
鲜蔬芙蓉汤	汤羹	菜品	汤羹	
鲜蘑油麦菜	热菜	菜品	热菜	
鲜蘑菇炒肉	热菜	菜品	热菜	
鲜虫草花炖乌鸡汤	汤羹	菜品	汤羹	
鲜虾一品粥	粥	主食	粥	
鲜虾仁加主食一起炒	热菜	菜品	热菜	
鲜虾仁滑蛋饭	盖浇饭	主食	饭	盖浇饭
鲜虾仁炒滑蛋	热菜	菜品	热菜	
鲜虾全麦面	健康餐	色拉轻食	健康餐	
鲜虾土鸡粥	粥	主食	粥	
鲜虾干贝粥	粥	主食	粥	
鲜虾手擀面	手擀面	主食	面	手擀面
鲜虾扒白菜	热菜	菜品	热菜	
鲜虾排骨芋头粥	粥	主食	粥	
鲜虾沙蟹粥	粥	主食	粥	
鲜虾滑汤面	汤面	主食	面	汤面
鲜虾炒滑蛋	热菜	菜品	热菜	
鲜虾炒藕片	热菜	菜品	热菜	
鲜虾牛肉粥	粥	主食	粥	
鲜虾玉米粥	粥	主食	粥	
鲜虾番茄炒滑蛋	热菜	菜品	热菜	
鲜虾瘦肉砂锅粥	粥	主食	粥	
鲜虾瘦肉粥	粥	主食	粥	
鲜虾砂锅粥	粥	主食	粥	
鲜虾萝卜丝汤	汤羹	菜品	汤羹	
鲜虾蚝仔粥	粥	主食	粥	
鲜虾蟹黄粥	粥	主食	粥	
鲜虾鱼片粥	粥	主食	粥	
鲜虾鸡蛋疙瘩汤	汤羹	菜品	汤羹	
鲜蚕豆米炒鸡蛋	热菜	菜品	热菜	
鲜蚝瘦肉粥	粥	主食	粥	
鲜蛋牛肉粥	粥	主食	粥	
鲜豆腐小白菜粉丝汤	其他粉	主食	粉	其他粉
鲜豆角丝炒肉	热菜	菜品	热菜	
鲜豆角炒肉丝	热菜	菜品	热菜	
鲜贝瘦肉粥	粥	主食	粥	
鲜贝鲍鱼粥	粥	主食	粥	
鲜野菇炒卤藕	热菜	菜品	热菜	
鲜香三鲜粥	粥	主食	粥	
鲜香姑炒肉	热菜	菜品	热菜	
鲜香干贝粥	粥	主食	粥	
鲜香椿炒鸡蛋	热菜	菜品	热菜	
鲜香甘甜的小青菜	其他菜品	其他	其他菜品	
鲜香菇炒肉	热菜	菜品	热菜	
鲜香菇炒肉丝	热菜	菜品	热菜	
鲜香菇炒肉片	热菜	菜品	热菜	
鲜香菇炖鸡	热菜	菜品	热菜	
鲜鱼味噌汤	汤羹	菜品	汤羹	
鲜鲍菇干烧芹菜	热菜	菜品	热菜	
鲜鲍鱼虾粥	粥	主食	粥	
鲜鲜的海带菜	凉菜	菜品	凉菜	
鲜鲩骨腩粥	粥	主食	粥	
鲜鲩鱼片粥	粥	主食	粥	
鲞豆腐皮汤面	汤面	主食	面	汤面
鲣鱼汤乌冬面	乌冬面	主食	面	乌冬面
鲩鱼骨腩粥	粥	主食	粥	
鲫鱼三鲜面	汤面	主食	面	汤面
鲫鱼炖豆腐	热菜	菜品	热菜	
鲫鱼炖豆腐汤	热菜	菜品	热菜	
鲫鱼瘦肉粥	粥	主食	粥	
鲫鱼荷包蛋汤	汤羹	菜品	汤羹	
鲫鱼萝卜丝汤	汤羹	菜品	汤羹	
鲫鱼萝卜汤	汤羹	菜品	汤羹	
鲫鱼豆腐汤	热菜	菜品	热菜	
鲫鱼豆腐白汤	汤羹	菜品	汤羹	
鲫鱼雪菜豆腐汤	汤羹	菜品	汤羹	
鲮鱼木耳炒菜心	热菜	菜品	热菜	
鲮鱼油麦菜	热菜	菜品	热菜	
鲶鱼沟香米饭	白米饭	主食	饭	白米饭
鲶鱼炖茄子	热菜	菜品	热菜	
鲶鱼炖茄子砂锅	热菜	菜品	热菜	
鲶鱼炖豆腐	热菜	菜品	热菜	
鳕鱼炖粉条	热菜	菜品	热菜	
鳕鱼炖豆腐	热菜	菜品	热菜	
鳕鱼炖豆腐套餐	其他菜品	其他	其他菜品	
鳕鱼炖豆腐汤菜微辣	热菜	菜品	热菜	
鳕鱼炖豆腐砂锅	热菜	菜品	热菜	
鳕鱼炖豆腐锅	热菜	菜品	热菜	
鳕鱼豆腐汤	汤羹	菜品	汤羹	
鳕鱼鱼排饭	其他饭	主食	饭	其他饭
鳗香炒芹菜	热菜	菜品	热菜	
鳗鱼砂锅粥	粥	主食	粥	
鳝鱼丝炒豆芽	热菜	菜品	热菜	
鸡丁炒芹菜盖饭	盖浇饭	主食	饭	盖浇饭
鸡丝娃娃菜	热菜	菜品	热菜	
鸡丝手擀面	手擀面	主食	面	手擀面
鸡丝拌莜面	拌面	主食	面	拌面
鸡丝拌菠菜	凉菜	菜品	凉菜	
鸡丝洋白菜盖饭	盖浇饭	主食	饭	盖浇饭
鸡丝炒皮不辣	凉皮	主食	凉皮	
鸡丝炒豆角	热菜	菜品	热菜	
鸡丝烩饼带汤	其他主食	主食	其他主食	
鸡丝玉米青菜粥	粥	主食	粥	
鸡丝粉丝洋白菜	热菜	菜品	热菜	
鸡丝草鸡蛋汤	汤羹	菜品	汤羹	
鸡丝荞麦面	拌面	主食	面	拌面
鸡丝菠菜凉面	凉面	主食	面	凉面
鸡丝蔬菜粥	粥	主食	粥	
鸡丝蛋炒饼	其他主食	主食	其他主食	
鸡丝蟹柳粥	粥	主食	粥	
鸡丝酸辣汤	汤羹	菜品	汤羹	
鸡丝青菜粥	粥	主食	粥	
鸡丝黄瓜凉面	凉面	主食	面	凉面
鸡丝龙利鱼荞麦面	健康餐	色拉轻食	健康餐	
鸡公煲特大份洋葱芹菜不含米饭	热菜	菜品	热菜	
鸡叉炖土豆	热菜	菜品	热菜	
鸡块土豆炖豆角	热菜	菜品	热菜	
鸡块炖土豆	热菜	菜品	热菜	
鸡块炖蘑菇	热菜	菜品	热菜	
鸡头米芦笋炒百合	热菜	菜品	热菜	
鸡旦肉饼汤	汤羹	菜品	汤羹	
鸡枞菌山药炒虾球	热菜	菜品	热菜	
鸡枞菌浇头面	拌面	主食	面	拌面
鸡枞菌炒芦笋	热菜	菜品	热菜	
鸡枞菌炒菜心	热菜	菜品	热菜	
鸡枞菌炒鲍片	热菜	菜品	热菜	
鸡枞菌炒鸡蛋	热菜	菜品	热菜	
鸡枞菌葱油面	汤面	主食	面	汤面
鸡柳炒香芹	热菜	菜品	热菜	
鸡毛小青菜	蔬菜类	火锅/串串/麻辣烫/色拉自选	配菜	蔬菜类
鸡毛菜清炒	热菜	菜品	热菜	
鸡毛菜炒百叶	热菜	菜品	热菜	
鸡汁清汤面	汤面	主食	面	汤面
鸡汤三鲜面	汤面	主食	面	汤面
鸡汤娃娃菜	热菜	菜品	热菜	
鸡汤小油菜	热菜	菜品	热菜	
鸡汤小青菜	汤羹	菜品	汤羹	
鸡汤手工面	汤面	主食	面	汤面
鸡汤手擀面	手擀面	主食	面	手擀面
鸡汤扬米面	汤面	主食	面	汤面
鸡汤紫菜汤	汤羹	菜品	汤羹	
鸡汤紫菜蛋花汤	汤羹	菜品	汤羹	
鸡汤菌味面	汤面	主食	面	汤面
鸡汤鱼豆腐面	汤面	主食	面	汤面
鸡汤鸡丝泡饭	泡饭	主食	饭	泡饭
鸡汤龙须面	汤面	主食	面	汤面
鸡炒茶树菇油白菜米粉	米线	主食	粉	米线
鸡翅香菇西红柿面	盖浇面	主食	面	盖浇面
鸡肉丸子汤	汤羹	菜品	汤羹	
鸡肉丸子粉丝汤	其他粉	主食	粉	其他粉
鸡肉冬菇捞饭	捞饭	主食	饭	捞饭
鸡肉拼茄子盖饭	其他饭	主食	饭	其他饭
鸡肉木耳丸子汤	汤羹	菜品	汤羹	
鸡肉炒三掺	米线	主食	粉	米线
鸡肉炒两掺	米线	主食	粉	米线
鸡肉炒拨疙瘩大份	炒面	主食	面	炒面
鸡肉炖土豆	热菜	菜品	热菜	
鸡肉炖土豆小	热菜	菜品	热菜	
鸡肉炖磨菇土豆	热菜	菜品	热菜	
鸡肉炖粉条的粉条	热菜	菜品	热菜	
鸡肉玉米汤	汤羹	菜品	汤羹	
鸡肉玉米粥	粥	主食	粥	
鸡肉番茄意面	意大利面	主食	面	意大利面
鸡肉胡萝卜青菜粥	粥	主食	粥	
鸡肉芹菜炒米粉	米线	主食	粉	米线
鸡肉蘑菇意面	意大利面	主食	面	意大利面
鸡肉蘑菇面	意大利面	主食	面	意大利面
鸡肉虾仁粥	粥	主食	粥	
鸡肉金丝粥	粥	主食	粥	
鸡肉香菇木耳烩饭配汤	其他菜品	其他	其他菜品	
鸡肉香菇粥	粥	主食	粥	
鸡胸五色杂粮饭	健康餐	色拉轻食	健康餐	
鸡脯丸子汤	汤羹	菜品	汤羹	
鸡腿炖土豆	热菜	菜品	热菜	
鸡腿炖蘑菇	热菜	菜品	热菜	
鸡腿炖蘑菇小份	热菜	菜品	热菜	
鸡腿炖香菇土豆	热菜	菜品	热菜	
鸡腿炖香菇粉条	热菜	菜品	热菜	
鸡腿肉炖土豆	热菜	菜品	热菜	
鸡腿菇肉手擀面	手擀面	主食	面	手擀面
鸡茸蘑菇汤	汤羹	菜品	汤羹	
鸡蛋丸子汤	汤羹	菜品	汤羹	
鸡蛋刀削面	其他面	主食	面	其他面
鸡蛋加瘦肉炒饭	炒饭	主食	饭	炒饭
鸡蛋外婆菜	热菜	菜品	热菜	
鸡蛋小白菜	饺子	主食	饺子	
鸡蛋干丝汤	汤羹	菜品	汤羹	
鸡蛋干拌菠菜面	拌面	主食	面	拌面
鸡蛋平菇汤	汤羹	菜品	汤羹	
鸡蛋手工面	手擀面	主食	面	手擀面
鸡蛋打卤面	盖浇面	主食	面	盖浇面
鸡蛋木耳炒大葱	热菜	菜品	热菜	
鸡蛋木耳炒苦瓜	热菜	菜品	热菜	
鸡蛋木耳炒菠菜	热菜	菜品	热菜	
鸡蛋柿子打卤面	盖浇面	主食	面	盖浇面
鸡蛋柿子汤	汤羹	菜品	汤羹	
鸡蛋柿子疙瘩汤	汤羹	菜品	汤羹	
鸡蛋柿子面	盖浇面	主食	面	盖浇面
鸡蛋炒刀削	其他面	主食	面	其他面
鸡蛋炒圆葱	热菜	菜品	面	炒面
鸡蛋炒土豆丝	热菜	菜品	热菜	
鸡蛋炒外婆菜	热菜	菜品	热菜	
鸡蛋炒广东米粉	米线	主食	粉	米线
鸡蛋炒拉条	炒面	主食	面	炒面
鸡蛋炒拨烂子	炒面	主食	面	炒面
鸡蛋炒揪片	炒面	主食	面	炒面
鸡蛋炒木耳	热菜	菜品	热菜	
鸡蛋炒木耳小份	热菜	菜品	热菜	
鸡蛋炒柿子	热菜	菜品	热菜	
鸡蛋炒毛葱	热菜	菜品	热菜	
鸡蛋炒洋芋擦擦	炒面	主食	面	炒面
鸡蛋炒瓜片	热菜	菜品	热菜	
鸡蛋炒米皮	凉皮	主食	凉皮	
鸡蛋炒米线	米线	其他	粉	米线
鸡蛋炒米饭	炒饭	主食	饭	炒饭
鸡蛋炒粉丝	热菜	菜品	热菜	
鸡蛋炒细米粉	米线	主食	粉	米线
鸡蛋炒芹菜盖饭	盖浇饭	主食	饭	盖浇饭
鸡蛋炒苦瓜	热菜	菜品	热菜	
鸡蛋炒荞面摊饼	炒面	主食	面	炒面
鸡蛋炒莜面	炒面	主食	面	炒面
鸡蛋炒莴笋	热菜	菜品	热菜	
鸡蛋炒菠菜	热菜	菜品	热菜	
鸡蛋炒蒜台	热菜	菜品	热菜	
鸡蛋炒蒜苔	热菜	菜品	热菜	
鸡蛋炒蒜苗	热菜	菜品	热菜	
鸡蛋炒西红柿	热菜	菜品	热菜	
鸡蛋炒西红柿盖饭	盖浇饭	主食	饭	盖浇饭
鸡蛋炒西葫芦盖饭	盖浇饭	主食	饭	盖浇饭
鸡蛋炒豆皮	热菜	菜品	热菜	
鸡蛋炒银鱼养殖	热菜	菜品	热菜	
鸡蛋炒韭菜	热菜	菜品	热菜	
鸡蛋炒饼丝	炒面	主食	面	炒面
鸡蛋炒馇子	热菜	菜品	热菜	
鸡蛋炒馍花	馒头	主食	馒头	
鸡蛋炒麻食	热菜	菜品	热菜	
鸡蛋炒黄瓜	热菜	菜品	热菜	
鸡蛋炒黄瓜片	热菜	菜品	热菜	
鸡蛋炒黄瓜盖饭	盖浇饭	主食	饭	盖浇饭
鸡蛋炖瘦肉汤	汤羹	菜品	汤羹	
鸡蛋炝锅面	汤面	主食	面	汤面
鸡蛋炝锅龙须面	汤面	主食	面	汤面
鸡蛋烩饼汤	其他主食	主食	其他主食	
鸡蛋焖饼赠送鸡蛋汤	其他主食	主食	其他主食	
鸡蛋片儿汤	汤羹	菜品	汤羹	
鸡蛋瓜片汤	汤羹	菜品	汤羹	
鸡蛋甘蓝炒河粉	其他粉	主食	粉	其他粉
鸡蛋甘蓝炒饭	炒饭	主食	饭	炒饭
鸡蛋番茄手擀面	手擀面	主食	面	手擀面
鸡蛋番茄捞面	其他面	主食	面	其他面
鸡蛋番茄汤	汤羹	菜品	汤羹	
鸡蛋番茄炒削面	其他面	主食	面	其他面
鸡蛋番茄面	汤面	主食	面	汤面
鸡蛋疙瘩汤	汤羹	菜品	汤羹	
鸡蛋瘦肉炒米线	米线	主食	粉	米线
鸡蛋瘦肉炒细米粉	米线	主食	粉	米线
鸡蛋瘦肉炒豆丝	热菜	菜品	热菜	
鸡蛋瘦肉粥	粥	主食	粥	
鸡蛋白菜汤	汤羹	菜品	汤羹	
鸡蛋白菜炒米粉	米线	主食	粉	米线
鸡蛋白菜炒粉	米线	主食	粉	米线
鸡蛋皮卷面	汤面	主食	面	汤面
鸡蛋粉丝炒包菜	热菜	菜品	热菜	
鸡蛋粉丝炒饼	其他主食	主食	其他主食	
鸡蛋素小炒	热菜	菜品	热菜	
鸡蛋紫菜汤	汤羹	菜品	汤羹	
鸡蛋肉丝炒豆皮子	热菜	菜品	热菜	
鸡蛋肉丝青菜炒饭	炒饭	主食	饭	炒饭
鸡蛋肉丝香菇炒米面	炒面	主食	面	炒面
鸡蛋肉松粥	粥	主食	粥	
鸡蛋肉泥汤	汤羹	菜品	汤羹	
鸡蛋肉饼汤	汤羹	菜品	汤羹	
鸡蛋菠菜汤	汤羹	菜品	汤羹	
鸡蛋营养面	其他菜品	其他	其他菜品	
鸡蛋葱油拌面	拌面	主食	面	拌面
鸡蛋葱花炒饭	炒饭	主食	饭	炒饭
鸡蛋蔬菜炒河粉	其他粉	主食	粉	其他粉
鸡蛋蔬菜炒面	炒面	主食	面	炒面
鸡蛋蔬菜炒饼	其他主食	主食	其他主食	
鸡蛋薄脆生菜	披萨	主食	披萨	
鸡蛋虾皮汆面	盖浇面	主食	面	盖浇面
鸡蛋西红柿打卤面	盖浇面	主食	面	盖浇面
鸡蛋西红柿拌面	拌面	主食	面	拌面
鸡蛋西红柿汤	汤羹	菜品	汤羹	
鸡蛋西红柿炒刀削面	其他面	主食	面	其他面
鸡蛋西红柿炒面	炒面	主食	面	炒面
鸡蛋西红柿疙瘩汤	汤羹	菜品	汤羹	
鸡蛋西红柿盖浇饭	盖浇饭	主食	饭	盖浇饭
鸡蛋西红柿盖饭	盖浇饭	主食	饭	盖浇饭
鸡蛋西红柿面	盖浇面	主食	面	盖浇面
鸡蛋豆干炒面	炒面	主食	面	炒面
鸡蛋豆皮粥	粥	主食	粥	
鸡蛋豆皮面	汤面	主食	面	汤面
鸡蛋豆腐小油菜汤	汤羹	菜品	汤羹	
鸡蛋豆腐汤	汤羹	菜品	汤羹	
鸡蛋豆腐皮粥	粥	主食	粥	
鸡蛋豆腐面	盖浇面	主食	面	盖浇面
鸡蛋酱打卤面	盖浇面	主食	面	盖浇面
鸡蛋酱菠菜	热菜	菜品	热菜	
鸡蛋酸拌汤	汤羹	菜品	汤羹	
鸡蛋醪糟粥	糖水/炖品	甜点	糖水/炖品	
鸡蛋雪菜炒粉	米线	主食	粉	米线
鸡蛋青菜泡饭	泡饭	主食	饭	泡饭
鸡蛋青菜炒	热菜	菜品	热菜	
鸡蛋青菜炒年糕	年糕	主食	年糕	
鸡蛋青菜炒河粉	其他粉	主食	粉	其他粉
鸡蛋青菜炒米粉	米线	主食	粉	米线
鸡蛋青菜炒细米粉	米线	主食	粉	米线
鸡蛋青菜炒面	炒面	主食	面	炒面
鸡蛋青菜炒饭	炒饭	主食	饭	炒饭
鸡蛋青菜面	汤面	主食	面	汤面
鸡蛋饼加生菜	其他主食	主食	其他主食	
鸡蛋饼卷菜	卷饼	主食	饼/囊/馍	卷饼
鸡蛋黄瓜打卤面	盖浇面	主食	面	盖浇面
鸡蛋黄瓜汤	汤羹	菜品	汤羹	
鸡蛋黄瓜炒面	炒面	主食	面	炒面
鸡蛋黄瓜片炒木耳	热菜	菜品	热菜	
鸡蛋黄花汤	汤羹	菜品	汤羹	
鸡骨架炖土豆	热菜	菜品	热菜	
鸡骨粉丝汤	其他粉	主食	粉	其他粉
鸭块海带汤	汤羹	菜品	汤羹	
鸭架小白菜豆腐汤	汤羹	菜品	汤羹	
鸭架白菜豆腐汤	汤羹	菜品	汤羹	
鸭汤小米粥	粥	主食	粥	
鸭肉粉丝汤	其他粉	主食	粉	其他粉
鸭胗炒芹菜	热菜	菜品	热菜	
鸭胗裙带菜	凉菜	菜品	凉菜	
鸭腿十鸡蛋十香干十青菜十饭	其他菜品	其他	其他菜品	
鸭血海带面	汤面	主食	面	汤面
鸭血烧豆腐饭	盖浇饭	主食	饭	盖浇饭
鸭血菜干汤	汤羹	菜品	汤羹	
鸭血豆腐汤	汤羹	菜品	汤羹	
鸭血豆腐青菜汤	汤羹	菜品	汤羹	
鸭血青菜汤	汤羹	菜品	汤羹	
鸭血鲜笋老鸭汤	汤羹	菜品	汤羹	
鸽子汤套饭	其他饭	主食	饭	其他饭
鸽子汤的炖罐	汤羹	菜品	汤羹	
鸽肉砂锅面	汤面	主食	面	汤面
鹅蛋拌小葱小白菜	凉菜	菜品	凉菜	
鹌鹑蛋炒芹菜	热菜	菜品	热菜	
鹌鹑蛋炒青菜	热菜	菜品	热菜	
鹌鹑蛋瘦肉香菇汤	汤羹	菜品	汤羹	
鹿茸菌山药粥	粥	主食	粥	
麦仁红芋粥	粥	主食	粥	
麦仁红豆稀饭	粥	主食	粥	
麦仁红豆粥	粥	主食	粥	
麦仁花生米粥	粥	主食	粥	
麦芹炒香干	热菜	菜品	热菜	
麦芽山楂炖瘦肉	汤羹	菜品	汤羹	
麻椒炒芹菜	热菜	菜品	热菜	
麻汁油麦菜	热菜	菜品	热菜	
麻油土豆小白菜	热菜	菜品	热菜	
麻油猪血汤	汤羹	菜品	汤羹	
麻蛤拌菠菜	热菜	菜品	热菜	
麻酱拌油麦菜	凉菜	菜品	凉菜	
麻酱松仁菠菜	凉菜	菜品	凉菜	
麻酱油麦菜	蔬菜类	菜品	配菜	蔬菜类
麻麻花炒土豆丝	热菜	菜品	热菜	
黄刺鱼炖豆腐	热菜	菜品	热菜	
黄古鱼豆腐汤	汤羹	菜品	汤羹	
黄叶菜清炒	热菜	菜品	热菜	
黄山毛笋尖炒肉丝	热菜	菜品	热菜	
黄山石耳炒鸡蛋	热菜	菜品	热菜	
黄山笋干炒肉	热菜	菜品	热菜	
黄山野笋炒肉丝	热菜	菜品	热菜	
黄桃银耳雪梨汤	其他菜品	其他	其他菜品	
黄河大米饭	白米饭	主食	饭	白米饭
黄烩海参饭	其他饭	主食	饭	其他饭
黄焖千页豆腐含米饭	其他菜品	其他	其他菜品	
黄焖土豆不含米饭	其他饭	主食	饭	其他饭
黄焖土豆鸡小份十米饭	其他菜品	其他	其他菜品	
黄焖素锅含米饭	其他菜品	其他	其他菜品	
黄焖茄子煲米饭	其他饭	主食	饭	其他饭
黄焖茄子米饭	其他饭	主食	饭	其他饭
黄焖茄子饭	其他饭	主食	饭	其他饭
黄焖豆腐饭	其他饭	主食	饭	其他饭
黄焖鸡内另加大白菜	浇头	其他	浇头	
黄焖鸡十土豆十青菜米饭	其他菜品	其他	其他菜品	
黄焖鸡十豆腐泡十千张十米饭	其他菜品	其他	其他菜品	
黄焖鸡单加娃娃菜	热菜	菜品	热菜	
黄焖鸡单加生菜	热菜	菜品	热菜	
黄焖鸡另加青菜	浇头	其他	浇头	
黄焖鸡大份不辣含米饭	其他饭	主食	饭	其他饭
黄焖鸡大份另送两种蔬菜一盒米饭	其他菜品	其他	其他菜品	
黄焖鸡小不辣含米饭	其他主食	主食	其他主食	
黄焖鸡小份土豆青菜米饭	其他菜品	其他	其他菜品	
黄焖鸡拼豆角饭	其他饭	主食	饭	其他饭
黄焖鸡米饭加香菇加金针菇加米饭	其他菜品	其他	其他菜品	
黄焖鸡米饭千张小白菜十米饭	其他菜品	其他	其他菜品	
黄焖鸡米饭小份加两种素菜加米饭	其他菜品	其他	其他菜品	
黄焖鸡米饭小份少肉含土豆一盒米饭	其他菜品	其他	其他菜品	
黄瓜丝土豆丝炒蚬肉	热菜	菜品	热菜	
黄瓜丝炒土豆丝	热菜	菜品	热菜	
黄瓜丸子汤	汤羹	菜品	汤羹	
黄瓜干炒鸡蛋	热菜	菜品	热菜	
黄瓜木耳炒肉	热菜	菜品	热菜	
黄瓜木耳炒肉片	热菜	菜品	热菜	
黄瓜木耳炒蛋	热菜	菜品	热菜	
黄瓜木耳炒鸡蛋	热菜	菜品	热菜	
黄瓜条小菜	凉菜	菜品	凉菜	
黄瓜柿子鸡蛋汤	汤羹	菜品	汤羹	
黄瓜炒土豆丝	热菜	菜品	热菜	
黄瓜炒木耳鸡蛋	热菜	菜品	热菜	
黄瓜炒河虾	热菜	菜品	热菜	
黄瓜炒肉片	热菜	菜品	热菜	
黄瓜炒肉盖浇饭	盖浇饭	主食	饭	盖浇饭
黄瓜炒藕尖	热菜	菜品	热菜	
黄瓜炒虾仁	热菜	菜品	热菜	
黄瓜炒蛋瓦煲饭	煲仔饭	主食	饭	煲仔饭
黄瓜炒蛋饭	盖浇饭	主食	饭	盖浇饭
黄瓜炒豆瓣	热菜	菜品	热菜	
黄瓜炒鳝鱼	盖浇饭	主食	饭	盖浇饭
黄瓜炒鳝鱼丝	热菜	菜品	热菜	
黄瓜炒鸡蛋	热菜	菜品	热菜	
黄瓜炒鸡蛋盖饭	盖浇饭	主食	饭	盖浇饭
黄瓜炖粉皮	热菜	菜品	热菜	
黄瓜煎蛋汤	汤羹	菜品	汤羹	
黄瓜片炒土豆片	热菜	菜品	热菜	
黄瓜片炒肉	热菜	菜品	热菜	
黄瓜片炒鸡蛋	热菜	菜品	热菜	
黄瓜片炒鸡蛋盖饭	盖浇饭	主食	饭	盖浇饭
黄瓜皮蛋汤	热菜	菜品	热菜	
黄瓜肉丝汤	汤羹	菜品	汤羹	
黄瓜肉丝炒拉皮	热菜	菜品	热菜	
黄瓜肉丝炒面	炒面	主食	面	炒面
黄瓜肉丝饭	盖浇饭	主食	饭	盖浇饭
黄瓜肉片汤	汤羹	菜品	汤羹	
黄瓜肉片饭	盖浇饭	主食	饭	盖浇饭
黄瓜脆炒肉	热菜	菜品	热菜	
黄瓜虾仁炒蛋	热菜	菜品	热菜	
黄瓜蛋花汤	汤羹	菜品	汤羹	
黄瓜鸡旦盖饭	盖浇饭	主食	饭	盖浇饭
黄瓜鸡蛋打卤面	盖浇面	主食	面	盖浇面
黄瓜鸡蛋汤	汤羹	菜品	汤羹	
黄瓜鸡蛋炒木耳	热菜	菜品	热菜	
黄瓜鸡蛋盖浇饭	盖浇饭	主食	饭	盖浇饭
黄瓜鸡蛋盖面	盖浇面	主食	面	盖浇面
黄瓜鸡蛋盖饭	盖浇饭	主食	饭	盖浇饭
黄粗面粗面	其他菜品	其他	其他菜品	
黄细玉米面	其他面	其他	面	其他面
黄细细细细面	其他菜品	其他	其他菜品	
黄花菜新菜	蔬菜类	火锅/串串/麻辣烫/色拉自选	配菜	蔬菜类
黄花菜炒肉	热菜	菜品	热菜	
黄花菜炖牛肉	热菜	菜品	热菜	
黄花菜瘦肉粥	粥	主食	粥	
黄花菜米面	拌面	主食	面	拌面
黄花蛋花汤	汤羹	菜品	汤羹	
黄花鱼丸子汤	汤羹	菜品	汤羹	
黄花鱼丸汤	汤羹	菜品	汤羹	
黄花鱼炖豆腐	热菜	菜品	热菜	
黄芽菜炒香菇	热菜	菜品	热菜	
黄蘑炒土豆片	热菜	菜品	热菜	
黄蘑蛋白汤	汤羹	菜品	汤羹	
黄蘑鸡蛋炒韭菜	热菜	菜品	热菜	
黄豆炒芥菜丝	蔬菜类	火锅/串串/麻辣烫/色拉自选	配菜	蔬菜类
黄豆牙炒肉	热菜	菜品	热菜	
黄豆腐干炒青椒	热菜	菜品	热菜	
黄豆芽土豆块小白菜	热菜	菜品	热菜	
黄豆芽炒粉	热菜	菜品	热菜	
黄豆芽炒粉丝	热菜	菜品	热菜	
黄豆芽炒粉条	热菜	菜品	热菜	
黄豆芽炒肉	热菜	菜品	热菜	
黄豆芽炒肉丝	热菜	菜品	热菜	
黄豆芽炒肉皮	热菜	菜品	热菜	
黄豆芽炒芥菜丝	热菜	菜品	热菜	
黄豆芽炒芹菜	热菜	菜品	热菜	
黄豆芽炖粉条	热菜	菜品	热菜	
黄豆酱炒鸡蛋	热菜	菜品	热菜	
黄金南瓜粥	粥	主食	粥	
黄金小米南瓜粥	粥	主食	粥	
黄金小米粥	粥	主食	粥	
黄金杂粮粥	粥	主食	粥	
黄金海参小米粥	粥	主食	粥	
黄金玉米南瓜粥	粥	主食	粥	
黄金玉米粥	粥	主食	粥	
黄金玉米面	其他菜品	其他	其他菜品	
黄金豆腐炒虾仁	热菜	菜品	热菜	
黄面条汤面	汤面	主食	面	汤面
黄鱼三鲜面	汤面	主食	面	汤面
黄鱼干姜汤面	汤面	主食	面	汤面
黄鱼雪菜面	汤面	主食	面	汤面
黄鱼麦虾汤	汤羹	菜品	汤羹	
黄黏玉米粗面	其他菜品	其他	其他菜品	
黎蒿炒香干	热菜	菜品	热菜	
黏玉米面粥	粥	主食	粥	
黑土地双米饭	白米饭	主食	饭	白米饭
黑土地玉米排骨汤	汤羹	菜品	汤羹	
黑土地米饭	白米饭	主食	饭	白米饭
黑家八宝粥	粥	主食	粥	
黑木耳山药炒黄瓜片	热菜	菜品	热菜	
黑木耳炒土鸡蛋	热菜	菜品	热菜	
黑木耳炒山药	热菜	菜品	热菜	
黑木耳炒淮山	热菜	菜品	热菜	
黑木耳炒白菜	热菜	菜品	热菜	
黑木耳炒肉	热菜	菜品	热菜	
黑木耳炒肉片	热菜	菜品	热菜	
黑木耳炒肉简餐	其他菜品	其他	其他菜品	
黑木耳炒莴笋	热菜	菜品	热菜	
黑木耳炒蛋	热菜	菜品	热菜	
黑木耳炒蛋饭	盖浇饭	主食	饭	盖浇饭
黑木耳炒西兰花	热菜	菜品	热菜	
黑木耳炒鸡毛菜	热菜	菜品	热菜	
黑木耳炒鸡蛋	热菜	菜品	热菜	
黑木耳肉丝十米饭	盖浇饭	主食	饭	盖浇饭
黑木耳肉丝面	盖浇面	主食	面	盖浇面
黑木耳豆腐汤	汤羹	菜品	汤羹	
黑松露蘑菇汤	汤羹	菜品	汤羹	
黑松露蘑菇面	意大利面	主食	面	意大利面
黑椒农场花菜	热菜	菜品	热菜	
黑椒口蘑炒秋葵	热菜	菜品	热菜	
黑椒炒杂菌	热菜	菜品	热菜	
黑焦醋锅爆白菜	热菜	菜品	热菜	
黑猪肉野蘑菇汤汤	汤羹	菜品	汤羹	
黑米五仁粥	粥	主食	粥	
黑米八宝粥	粥	主食	粥	
黑米八宝配小菜	粥	主食	粥	
黑米养生粥	粥	主食	粥	
黑米大枣枸杞粥	粥	主食	粥	
黑米小枣枸杞滋补粥	粥	主食	粥	
黑米山药粥	粥	主食	粥	
黑米无糖八宝粥	粥	主食	粥	
黑米早餐粥	粥	主食	粥	
黑米杂粮粥	粥	主食	粥	
黑米果仁粥	粥	主食	粥	
黑米桂圆红枣粥	粥	主食	粥	
黑米桂花粥	粥	主食	粥	
黑米汤圆粥	粥	主食	粥	
黑米热稀饭	粥	主食	粥	
黑米燕麦混合粥	粥	主食	粥	
黑米燕麦粥	粥	主食	粥	
黑米燕麦营养粥	粥	主食	粥	
黑米甜枣粥	粥	主食	粥	
黑米粥八宝粥	粥	主食	粥	
黑米紫米八宝粥	粥	主食	粥	
黑米紫薯粥	粥	主食	粥	
黑米红枣桂圆粥	粥	主食	粥	
黑米红枣燕麦粥	粥	主食	粥	
黑米红枣粥	粥	主食	粥	
黑米红枣红豆粥	粥	主食	粥	
黑米红豆粥	粥	主食	粥	
黑米红豆红枣粥	粥	主食	粥	
黑米红豆薏米粥	粥	主食	粥	
黑米绿豆粥	粥	主食	粥	
黑米腊八粥	粥	主食	粥	
黑米花生粥	粥	主食	粥	
黑米花生营养粥	粥	主食	粥	
黑米苗条粥	粥	主食	粥	
黑米营养粥	粥	主食	粥	
黑米薏仁粥	粥	菜品	粥	
黑糖燕麦粥	粥	主食	粥	
黑糯米五仁粥	粥	主食	粥	
黑色荞麦冷面	凉面	主食	面	凉面
黑芝麻核桃桂圆粥	粥	主食	粥	
黑芝麻核桃蛋花汤	糖水/炖品	甜点	糖水/炖品	
黑芝麻桃仁粥	粥	主食	粥	
黑芝麻燕麦粥	粥	主食	粥	
黑芝麻糯米粥	粥	主食	粥	
黑菜炒豆芽	热菜	菜品	热菜	
黑菜老豆腐汤	汤羹	菜品	汤羹	
黑豆乌鸡汤	汤羹	菜品	汤羹	
黑豆尾骨汤	汤羹	菜品	汤羹	
黑豆花生瘦肉粥	粥	主食	粥	
黑豆苗炒粉条	热菜	菜品	热菜	
黑鱼三鲜面	汤面	主食	面	汤面
黑鱼片汤面	汤面	主食	面	汤面
黑鱼片鲜虾粥	粥	主食	粥	
黑鱼砂锅粥	粥	主食	粥	
黑鱼豆腐汤	汤羹	菜品	汤羹	
黑麦面疙瘩汤	汤羹	菜品	汤羹	
默认粗玉米面	其他菜品	其他	其他菜品	
黟县小炒笋	热菜	菜品	热菜	
黟县小炒笋盖浇饭	盖浇饭	主食	饭	盖浇饭
龙利鱼什疏杂粮饭	健康餐	色拉轻食	健康餐	
龙山小米粥	粥	主食	粥	
龙山石笋炖老鸭	热菜	菜品	热菜	
龙成艇仔粥	粥	主食	粥	
龙江小米粥	粥	主食	粥	
龙胆石斑鱼皮粥	粥	主食	粥	
龙胆石斑鱼腩粥	粥	主食	粥	
龙须菜元贝炒鸡蛋	热菜	菜品	热菜	
龙须菜炒扇贝肉	热菜	菜品	热菜	
龙须菜炒鸡蛋	热菜	菜品	热菜	
龙须菜鸡蛋炒蚬肉	热菜	菜品	热菜	
龙骨炖海带苗	热菜	菜品	热菜	
